CTTTAACCACTGACATCGAC -> TTTAACCACTGACATCGACC
TAACAGTCAGGGCACTAAAG -> AACAGTCAGGGCACTAAAGA
CCTGGACCTCAAGGAGTACA -> CTGGACCTCAAGGAGTACAC
TAGATTACGGTGAAACTAAC -> AGATTACGGTGAAACTAACA
ATAAGACATGGGGGTCATCC -> TAAGACATGGGGGTCATCCG
AAAGGCCGGGAAGCGTCGAT -> AAGGCCGGGAAGCGTCGATA
AGCCATACGCGTAAAGGTCC -> GCCATACGCGTAAAGGTCCT
AGGGCCTACCTCTTAAAGCT -> GGGCCTACCTCTTAAAGCTA
AAATCTAGGTCGCACGCCAA -> AATCTAGGTCGCACGCCAAA
ATGCCAAATGTTGTACATAA -> TGCCAAATGTTGTACATAAA
CCCAGTGGCTGGCGGACTAA -> CCAGTGGCTGGCGGACTAAA
CTAATGACCTAGGAAGGTGA -> TAATGACCTAGGAAGGTGAC
TTAATAATCATAGATGAGGT -> TAATAATCATAGATGAGGTC
CTTTCTTAATAATCATAGAT -> TTTCTTAATAATCATAGATG
TCCCTCTAGGATGCTCTTTT -> CCCTCTAGGATGCTCTTTTA
GGTCGTTTTCCCGGGTTCTT -> GTCGTTTTCCCGGGTTCTTC
TCCGATGCCTGAGTACCTGA -> CCGATGCCTGAGTACCTGAC
TTTTAACTGGTAATACAGGC -> TTTAACTGGTAATACAGGCG
GTGTCGATATCCTATTCTGT -> TGTCGATATCCTATTCTGTA
TTCCCGGGTTCTTCCAAATC -> TCCCGGGTTCTTCCAAATCC
TTCTGTAGATCTTAGCACGG -> TCTGTAGATCTTAGCACGGC
ACTGACATCGACCCCGCAGT -> CTGACATCGACCCCGCAGTT
CCACGTTTTTAACTGGTAAT -> CACGTTTTTAACTGGTAATA
AGGTCATACCCTACCCTAGG -> GGTCATACCCTACCCTAGGC
TCAGAGACTGCAAAGCCATA -> CAGAGACTGCAAAGCCATAC
CACGGCATGCTTAACTTAGG -> ACGGCATGCTTAACTTAGGG
TTTTCCCGGGTTCTTCCAAA -> TTTCCCGGGTTCTTCCAAAT
GACTAAAATCTAGGTCGCAC -> ACTAAAATCTAGGTCGCACG
GCTCTTTTATTATAGGGTCC -> CTCTTTTATTATAGGGTCCA
CTACCCTAGGCTAGTGAGGG -> TACCCTAGGCTAGTGAGGGC
GGGGTCATCCGGTGGTAAAG -> GGGTCATCCGGTGGTAAAGG
CACGTTTTTAACTGGTAATA -> ACGTTTTTAACTGGTAATAC
CCGATGCCTGAGTACCTGAC -> CGATGCCTGAGTACCTGACT
ATAGGGTCCATAGTCAGTAT -> TAGGGTCCATAGTCAGTATA
TCCGGCTCAGGTCCCTCTAG -> CCGGCTCAGGTCCCTCTAGG
GCGTGAGACAGACAGTATGT -> CGTGAGACAGACAGTATGTT
TGAGGTCGTTTTCCCGGGTT -> GAGGTCGTTTTCCCGGGTTC
GACCTTCTTTGCTGCGTTGC -> ACCTTCTTTGCTGCGTTGCG
TTTCAGTTTAACGGCCGTTT -> TTCAGTTTAACGGCCGTTTC
TGGCTGGCGGACTAAAATCT -> GGCTGGCGGACTAAAATCTA
CATGTCAATCGTGTTTATCG -> ATGTCAATCGTGTTTATCGG
GTCCACTTATTATGTCTGGA -> TCCACTTATTATGTCTGGAC
ACAAACTCACTACCGGGTGT -> CAAACTCACTACCGGGTGTG
GCAGTGATATTAGCCGTGTC -> CAGTGATATTAGCCGTGTCG
GTCATCCGGTGGTAAAGGCC -> TCATCCGGTGGTAAAGGCCG
ATTATGTCTGGACCAGTGTT -> TTATGTCTGGACCAGTGTTC
AGTGTTCCGCGACGTATGGT -> GTGTTCCGCGACGTATGGTT
GCGGACTAAAATCTAGGTCG -> CGGACTAAAATCTAGGTCGC
CAAAGCCATACGCGTAAAGG -> AAAGCCATACGCGTAAAGGT
TATTATGTCTGGACCAGTGT -> ATTATGTCTGGACCAGTGTT
TAAAAAGGGACGTGTCGATA -> AAAAAGGGACGTGTCGATAT
GTCCATAGTCAGTATAATCG -> TCCATAGTCAGTATAATCGC
TAAATACGGGAATCACACGG -> AAATACGGGAATCACACGGG
CTGAGTACCTGACTTCTCTT -> TGAGTACCTGACTTCTCTTT
GGTCATACCCTACCCTAGGC -> GTCATACCCTACCCTAGGCT
CGTAAAGGTCCTACTCTTGC -> GTAAAGGTCCTACTCTTGCC
CCGGGTGTGACCTCAGAGTG -> CGGGTGTGACCTCAGAGTGA
AGGGACGTGTCGATATCCTA -> GGGACGTGTCGATATCCTAT
TACGGTGAAACTAACAGTCA -> ACGGTGAAACTAACAGTCAG
ACCACTGACATCGACCCCGC -> CCACTGACATCGACCCCGCA
TGTAAGTCTGAGCTGATTCC -> GTAAGTCTGAGCTGATTCCG
AATACGGGAATCACACGGGA -> ATACGGGAATCACACGGGAC
CCTCTTAAAGCTACGCCAAG -> CTCTTAAAGCTACGCCAAGC
ATACCCTACCCTAGGCTAGT -> TACCCTACCCTAGGCTAGTG
GTGTCGGGCTGGCATGTCAA -> TGTCGGGCTGGCATGTCAAT
ACCACGTTTTTAACTGGTAA -> CCACGTTTTTAACTGGTAAT
TGAGACAGACAGTATGTTCT -> GAGACAGACAGTATGTTCTG
GGACTTTAACCACTGACATC -> GACTTTAACCACTGACATCG
ACCAGTGTTCCGCGACGTAT -> CCAGTGTTCCGCGACGTATG
CTCGCTCTGATAAGACATGG -> TCGCTCTGATAAGACATGGG
AGCGCTTATAGTTAAATCCT -> GCGCTTATAGTTAAATCCTT
CGCCAGGTCATACCCTACCC -> GCCAGGTCATACCCTACCCT
GGTCGCACGCCAAAAATTTC -> GTCGCACGCCAAAAATTTCA
CAATCGTGTTTATCGGCGGG -> AATCGTGTTTATCGGCGGGA
CGACGTATGGTTTTGGCCCC -> GACGTATGGTTTTGGCCCCG
TGACATCGACCCCGCAGTTG -> GACATCGACCCCGCAGTTGG
TTATTATAGGGTCCATAGTC -> TATTATAGGGTCCATAGTCA
GTAGTATCCGCACTCCATGA -> TAGTATCCGCACTCCATGAC
TAATACAGGCGGCGTCTGGT -> AATACAGGCGGCGTCTGGTG
CCGGGAAGCGTCGATACGGT -> CGGGAAGCGTCGATACGGTG
CCTGACTTCTCTTTATAATA -> CTGACTTCTCTTTATAATAA
ATCCGGTGGTAAAGGCCGGG -> TCCGGTGGTAAAGGCCGGGA
CTATTCTGTAGATCTTAGCA -> TATTCTGTAGATCTTAGCAC
CCGGCTCAGGTCCCTCTAGG -> CGGCTCAGGTCCCTCTAGGA
TTTCCCGGGTTCTTCCAAAT -> TTCCCGGGTTCTTCCAAATC
GGGCCCGTTTTGCACGCTAA -> GGCCCGTTTTGCACGCTAAT
AATTTCAGTTTAACGGCCGT -> ATTTCAGTTTAACGGCCGTT
GTGACTCGTCCACTTATTAT -> TGACTCGTCCACTTATTATG
GCTGACCTCGGAGCTCCATA -> CTGACCTCGGAGCTCCATAA
ATTAGTAGTATCCGCACTCC -> TTAGTAGTATCCGCACTCCA
CGTGTCGATATCCTATTCTG -> GTGTCGATATCCTATTCTGT
CTGGTAATACAGGCGGCGTC -> TGGTAATACAGGCGGCGTCT
GTCGATACGGTGCTGACCTC -> TCGATACGGTGCTGACCTCG
TTCTTAATAATCATAGATGA -> TCTTAATAATCATAGATGAG
TTCAGTTTAACGGCCGTTTC -> TCAGTTTAACGGCCGTTTCG
CGCAGTTGGTCAGATTCACT -> GCAGTTGGTCAGATTCACTA
GGCTGGCGGACTAAAATCTA -> GCTGGCGGACTAAAATCTAG
CGCGACGTATGGTTTTGGCC -> GCGACGTATGGTTTTGGCCC
ACTAAAATCTAGGTCGCACG -> CTAAAATCTAGGTCGCACGC
TCGGGCTGGCATGTCAATCG -> CGGGCTGGCATGTCAATCGT
CTGGACCTCAAGGAGTACAC -> TGGACCTCAAGGAGTACACG
TGCGCACACAACTTTCTTAA -> GCGCACACAACTTTCTTAAT
CACGATAACAAACTCACTAC -> ACGATAACAAACTCACTACC
TGAAACTAACAGTCAGGGCA -> GAAACTAACAGTCAGGGCAC
TGCCACCACGTTTTTAACTG -> GCCACCACGTTTTTAACTGG
TTCACTAATGCCAAATGTTG -> TCACTAATGCCAAATGTTGT
GAAGCGCTTATAGTTAAATC -> AAGCGCTTATAGTTAAATCC
AAATTTCAGTTTAACGGCCG -> AATTTCAGTTTAACGGCCGT
AAGACCCTGGACCTCAAGGA -> AGACCCTGGACCTCAAGGAG
ACTCAGAGACTGCAAAGCCA -> CTCAGAGACTGCAAAGCCAT
CTAGGAAGGTGACTCAGAGA -> TAGGAAGGTGACTCAGAGAC
TACCTCTTAAAGCTACGCCA -> ACCTCTTAAAGCTACGCCAA
GTCCCTCTAGGATGCTCTTT -> TCCCTCTAGGATGCTCTTTT
TACCCTAGGCTAGTGAGGGC -> ACCCTAGGCTAGTGAGGGCC
CCACCACGTTTTTAACTGGT -> CACCACGTTTTTAACTGGTA
CCTATTCTGTAGATCTTAGC -> CTATTCTGTAGATCTTAGCA
ATGTTCTGCCTCGCTCTGAT -> TGTTCTGCCTCGCTCTGATA
CGTCCGATGCCTGAGTACCT -> GTCCGATGCCTGAGTACCTG
TTAACGGCCGTTTCGTGTAA -> TAACGGCCGTTTCGTGTAAG
AGTTTAACGGCCGTTTCGTG -> GTTTAACGGCCGTTTCGTGT
CCTATTAGTAGTATCCGCAC -> CTATTAGTAGTATCCGCACT
AGGTGACTCAGAGACTGCAA -> GGTGACTCAGAGACTGCAAA
AAAGCCATACGCGTAAAGGT -> AAGCCATACGCGTAAAGGTC
AAGGTCCTACTCTTGCCACC -> AGGTCCTACTCTTGCCACCA
TTAGTAGTATCCGCACTCCA -> TAGTAGTATCCGCACTCCAT
TCCGGTGGTAAAGGCCGGGA -> CCGGTGGTAAAGGCCGGGAA
TGTAGATCTTAGCACGGCAT -> GTAGATCTTAGCACGGCATG
TATAGTTAAATCCTTATACA -> ATAGTTAAATCCTTATACAG
GACATCGACCCCGCAGTTGG -> ACATCGACCCCGCAGTTGGT
CGGCTCAGGTCCCTCTAGGA -> GGCTCAGGTCCCTCTAGGAT
AGGCAGTGATATTAGCCGTG -> GGCAGTGATATTAGCCGTGT
GGAAGCGTCGATACGGTGCT -> GAAGCGTCGATACGGTGCTG
CTCTTGCCACCACGTTTTTA -> TCTTGCCACCACGTTTTTAA
CGTTTCGTGTAAGTCTGAGC -> GTTTCGTGTAAGTCTGAGCT
TGGTTTTGGCCCCGAAACTC -> GGTTTTGGCCCCGAAACTCC
AAGGAGTACACGATAACAAA -> AGGAGTACACGATAACAAAC
TGCCAAATGTTGTACATAAA -> GCCAAATGTTGTACATAAAT
GCCTCGCTCTGATAAGACAT -> CCTCGCTCTGATAAGACATG
GGGTGTGACCTCAGAGTGAC -> GGTGTGACCTCAGAGTGACT
AGACCCTGGACCTCAAGGAG -> GACCCTGGACCTCAAGGAGT
TATTATAGGGTCCATAGTCA -> ATTATAGGGTCCATAGTCAG
ACATGGGGGTCATCCGGTGG -> CATGGGGGTCATCCGGTGGT
ACTGAGGACCTTCTTTGCTG -> CTGAGGACCTTCTTTGCTGC
CTAATGCCAAATGTTGTACA -> TAATGCCAAATGTTGTACAT
GGGTCATCCGGTGGTAAAGG -> GGTCATCCGGTGGTAAAGGC
ACACGATAACAAACTCACTA -> CACGATAACAAACTCACTAC
TATACAGCACTTCTAGATTA -> ATACAGCACTTCTAGATTAC
AAGGCCGGGAAGCGTCGATA -> AGGCCGGGAAGCGTCGATAC
TCAGAGTGACTCGTCCACTT -> CAGAGTGACTCGTCCACTTA
TGCTGACCTCGGAGCTCCAT -> GCTGACCTCGGAGCTCCATA
CTCTTTATAATAAAAAGGGA -> TCTTTATAATAAAAAGGGAC
TAGGGTCCATAGTCAGTATA -> AGGGTCCATAGTCAGTATAA
AACTCCCAGTGGCTGGCGGA -> ACTCCCAGTGGCTGGCGGAC
TACACGATAACAAACTCACT -> ACACGATAACAAACTCACTA
ACTAAAGACCCTGGACCTCA -> CTAAAGACCCTGGACCTCAA
TTAGGGGCCCGTTTTGCACG -> TAGGGGCCCGTTTTGCACGC
TCACTACCGGGTGTGACCTC -> CACTACCGGGTGTGACCTCA
GCGGCGTCTGGTGGGCGAGG -> CGGCGTCTGGTGGGCGAGGG
GCTAATGACCTAGGAAGGTG -> CTAATGACCTAGGAAGGTGA
ACCTCAGAGTGACTCGTCCA -> CCTCAGAGTGACTCGTCCAC
TCCAAATCCTATTAGTAGTA -> CCAAATCCTATTAGTAGTAT
CTTTGCTGCGTTGCGCACAC -> TTTGCTGCGTTGCGCACACA
CTTATTATGTCTGGACCAGT -> TTATTATGTCTGGACCAGTG
CACGCTAATGACCTAGGAAG -> ACGCTAATGACCTAGGAAGG
GGCTAGTGAGGGCCTACCTC -> GCTAGTGAGGGCCTACCTCT
TAGTCAGTATAATCGCCAAA -> AGTCAGTATAATCGCCAAAT
TGGGCGAGGGAGGCAGTGAT -> GGGCGAGGGAGGCAGTGATA
GCGTCCGATGCCTGAGTACC -> CGTCCGATGCCTGAGTACCT
GTATGTTCTGCCTCGCTCTG -> TATGTTCTGCCTCGCTCTGA
AATGTTGTACATAAATACGG -> ATGTTGTACATAAATACGGG
AAGGGACGTGTCGATATCCT -> AGGGACGTGTCGATATCCTA
CAAACTCACTACCGGGTGTG -> AAACTCACTACCGGGTGTGA
TTAAAGCTACGCCAAGCGAC -> TAAAGCTACGCCAAGCGACT
GGTAATACAGGCGGCGTCTG -> GTAATACAGGCGGCGTCTGG
TAATAAAAAGGGACGTGTCG -> AATAAAAAGGGACGTGTCGA
AATCCTTATACAGCACTTCT -> ATCCTTATACAGCACTTCTA
CAGCACTTCTAGATTACGGT -> AGCACTTCTAGATTACGGTG
GAAGCGTCGATACGGTGCTG -> AAGCGTCGATACGGTGCTGA
ATCGACCCCGCAGTTGGTCA -> TCGACCCCGCAGTTGGTCAG
TCTTAATAATCATAGATGAG -> CTTAATAATCATAGATGAGG
ATAATAAAAAGGGACGTGTC -> TAATAAAAAGGGACGTGTCG
ACGTTTTTAACTGGTAATAC -> CGTTTTTAACTGGTAATACA
CAAAAATTTCAGTTTAACGG -> AAAAATTTCAGTTTAACGGC
CCCTCTAGGATGCTCTTTTA -> CCTCTAGGATGCTCTTTTAT
ATTCCGGCTCAGGTCCCTCT -> TTCCGGCTCAGGTCCCTCTA
TGCTCTTTTATTATAGGGTC -> GCTCTTTTATTATAGGGTCC
AGCGTCGATACGGTGCTGAC -> GCGTCGATACGGTGCTGACC
CTACCTCTTAAAGCTACGCC -> TACCTCTTAAAGCTACGCCA
ATTTGCGTCCGATGCCTGAG -> TTTGCGTCCGATGCCTGAGT
TATTCTGTAGATCTTAGCAC -> ATTCTGTAGATCTTAGCACG
GACCAGTGTTCCGCGACGTA -> ACCAGTGTTCCGCGACGTAT
GACCTCAGAGTGACTCGTCC -> ACCTCAGAGTGACTCGTCCA
TATAGGGTCCATAGTCAGTA -> ATAGGGTCCATAGTCAGTAT
TAGGCTAGTGAGGGCCTACC -> AGGCTAGTGAGGGCCTACCT
AACTGGTAATACAGGCGGCG -> ACTGGTAATACAGGCGGCGT
CCCTAGGCTAGTGAGGGCCT -> CCTAGGCTAGTGAGGGCCTA
GTAAAGGCCGGGAAGCGTCG -> TAAAGGCCGGGAAGCGTCGA
TTTGCTGCGTTGCGCACACA -> TTGCTGCGTTGCGCACACAA
TCCATGACCCCGAAGCGCTT -> CCATGACCCCGAAGCGCTTA
GATCTTAGCACGGCATGCTT -> ATCTTAGCACGGCATGCTTA
CATCCGGTGGTAAAGGCCGG -> ATCCGGTGGTAAAGGCCGGG
CGTTTTGCACGCTAATGACC -> GTTTTGCACGCTAATGACCT
TTTGCACGCTAATGACCTAG -> TTGCACGCTAATGACCTAGG
CGAAGCGCTTATAGTTAAAT -> GAAGCGCTTATAGTTAAATC
GCTAGTGAGGGCCTACCTCT -> CTAGTGAGGGCCTACCTCTT
AGCACTTCTAGATTACGGTG -> GCACTTCTAGATTACGGTGA
GTTTAACGGCCGTTTCGTGT -> TTTAACGGCCGTTTCGTGTA
TAATGACCTAGGAAGGTGAC -> AATGACCTAGGAAGGTGACT
ACGCGTAAAGGTCCTACTCT -> CGCGTAAAGGTCCTACTCTT
TAAGACATGGGGGTCATCCG -> AAGACATGGGGGTCATCCGG
CTCAGGTCCCTCTAGGATGC -> TCAGGTCCCTCTAGGATGCT
CTACTCTTGCCACCACGTTT -> TACTCTTGCCACCACGTTTT
AATCCTATTAGTAGTATCCG -> ATCCTATTAGTAGTATCCGC
GTCGGGCTGGCATGTCAATC -> TCGGGCTGGCATGTCAATCG
GTGAAACTAACAGTCAGGGC -> TGAAACTAACAGTCAGGGCA
TAACGGCCGTTTCGTGTAAG -> AACGGCCGTTTCGTGTAAGT
TCTGAGCTGATTCCGGCTCA -> CTGAGCTGATTCCGGCTCAG
CAGTTTAACGGCCGTTTCGT -> AGTTTAACGGCCGTTTCGTG
CCATAGTCAGTATAATCGCC -> CATAGTCAGTATAATCGCCA
AGTTGGTCAGATTCACTAAT -> GTTGGTCAGATTCACTAATG
CAGTCAGGGCACTAAAGACC -> AGTCAGGGCACTAAAGACCC
CACTTCTAGATTACGGTGAA -> ACTTCTAGATTACGGTGAAA
AGGTCCTACTCTTGCCACCA -> GGTCCTACTCTTGCCACCAC
CGATAACAAACTCACTACCG -> GATAACAAACTCACTACCGG
TCTTCCAAATCCTATTAGTA -> CTTCCAAATCCTATTAGTAG
CCCGTTTTGCACGCTAATGA -> CCGTTTTGCACGCTAATGAC
CGCGTGAGACAGACAGTATG -> GCGTGAGACAGACAGTATGT
TAATGCCAAATGTTGTACAT -> AATGCCAAATGTTGTACATA
GGCACTAAAGACCCTGGACC -> GCACTAAAGACCCTGGACCT
ACTCCATGACCCCGAAGCGC -> CTCCATGACCCCGAAGCGCT
CTTGCCACCACGTTTTTAAC -> TTGCCACCACGTTTTTAACT
TGCTTAACTTAGGGGCCCGT -> GCTTAACTTAGGGGCCCGTT
GATGCCTGAGTACCTGACTT -> ATGCCTGAGTACCTGACTTC
TAGCCGTGTCGGGCTGGCAT -> AGCCGTGTCGGGCTGGCATG
GCTCCATAACGTAGGAGAGT -> CTCCATAACGTAGGAGAGTT
GGACCGCGTGAGACAGACAG -> GACCGCGTGAGACAGACAGT
ACGGGAATCACACGGGACCG -> CGGGAATCACACGGGACCGC
GTTGCGCACACAACTTTCTT -> TTGCGCACACAACTTTCTTA
ATTACGGTGAAACTAACAGT -> TTACGGTGAAACTAACAGTC
ACACAACTTTCTTAATAATC -> CACAACTTTCTTAATAATCA
TGACCTCGGAGCTCCATAAC -> GACCTCGGAGCTCCATAACG
ACAGTATGTTCTGCCTCGCT -> CAGTATGTTCTGCCTCGCTC
GATACGGTGCTGACCTCGGA -> ATACGGTGCTGACCTCGGAG
AGTGACTCGTCCACTTATTA -> GTGACTCGTCCACTTATTAT
GACCTCGGAGCTCCATAACG -> ACCTCGGAGCTCCATAACGT
GGAATCACACGGGACCGCGT -> GAATCACACGGGACCGCGTG
CACTAATGCCAAATGTTGTA -> ACTAATGCCAAATGTTGTAC
TTTAACGGCCGTTTCGTGTA -> TTAACGGCCGTTTCGTGTAA
GACAGACAGTATGTTCTGCC -> ACAGACAGTATGTTCTGCCT
AAAAATTTCAGTTTAACGGC -> AAAATTTCAGTTTAACGGCC
GTATGGTTTTGGCCCCGAAA -> TATGGTTTTGGCCCCGAAAC
CCTCAGAGTGACTCGTCCAC -> CTCAGAGTGACTCGTCCACT
AGACATGGGGGTCATCCGGT -> GACATGGGGGTCATCCGGTG
TGCAAAGCCATACGCGTAAA -> GCAAAGCCATACGCGTAAAG
AGACAGTATGTTCTGCCTCG -> GACAGTATGTTCTGCCTCGC
AGGTCGTTTTCCCGGGTTCT -> GGTCGTTTTCCCGGGTTCTT
CCGAAGCGCTTATAGTTAAA -> CGAAGCGCTTATAGTTAAAT
GATTACGGTGAAACTAACAG -> ATTACGGTGAAACTAACAGT
TTGCGTCCGATGCCTGAGTA -> TGCGTCCGATGCCTGAGTAC
GTACATAAATACGGGAATCA -> TACATAAATACGGGAATCAC
AGGCTAGTGAGGGCCTACCT -> GGCTAGTGAGGGCCTACCTC
CACAACTTTCTTAATAATCA -> ACAACTTTCTTAATAATCAT
TGGTGGGCGAGGGAGGCAGT -> GGTGGGCGAGGGAGGCAGTG
TTCTTCCAAATCCTATTAGT -> TCTTCCAAATCCTATTAGTA
ATTAGCCGTGTCGGGCTGGC -> TTAGCCGTGTCGGGCTGGCA
ATAGTTAAATCCTTATACAG -> TAGTTAAATCCTTATACAGC
AGTGAGGGCCTACCTCTTAA -> GTGAGGGCCTACCTCTTAAA
TACTCTTGCCACCACGTTTT -> ACTCTTGCCACCACGTTTTT
AAAAGGGACGTGTCGATATC -> AAAGGGACGTGTCGATATCC
CCTCGGAGCTCCATAACGTA -> CTCGGAGCTCCATAACGTAG
AGGCCGGGAAGCGTCGATAC -> GGCCGGGAAGCGTCGATACG
TCCTATTAGTAGTATCCGCA -> CCTATTAGTAGTATCCGCAC
CCGAAACTCCCAGTGGCTGG -> CGAAACTCCCAGTGGCTGGC
AAGCGCTTATAGTTAAATCC -> AGCGCTTATAGTTAAATCCT
ACGGTGAAACTAACAGTCAG -> CGGTGAAACTAACAGTCAGG
GCGTTGCGCACACAACTTTC -> CGTTGCGCACACAACTTTCT
TGGTAAAGGCCGGGAAGCGT -> GGTAAAGGCCGGGAAGCGTC
ACTGCAAAGCCATACGCGTA -> CTGCAAAGCCATACGCGTAA
GGTTTTGGCCCCGAAACTCC -> GTTTTGGCCCCGAAACTCCC
AAATACGGGAATCACACGGG -> AATACGGGAATCACACGGGA
GCCGGGAAGCGTCGATACGG -> CCGGGAAGCGTCGATACGGT
GCGACGTATGGTTTTGGCCC -> CGACGTATGGTTTTGGCCCC
TATGTTCTGCCTCGCTCTGA -> ATGTTCTGCCTCGCTCTGAT
CACTGACATCGACCCCGCAG -> ACTGACATCGACCCCGCAGT
TGACTCAGAGACTGCAAAGC -> GACTCAGAGACTGCAAAGCC
CTGATTCCGGCTCAGGTCCC -> TGATTCCGGCTCAGGTCCCT
TGGCCCCGAAACTCCCAGTG -> GGCCCCGAAACTCCCAGTGG
CATGGGGGTCATCCGGTGGT -> ATGGGGGTCATCCGGTGGTA
GGACCTCAAGGAGTACACGA -> GACCTCAAGGAGTACACGAT
TGAGTACCTGACTTCTCTTT -> GAGTACCTGACTTCTCTTTA
CATGACCCCGAAGCGCTTAT -> ATGACCCCGAAGCGCTTATA
CCGCAGTTGGTCAGATTCAC -> CGCAGTTGGTCAGATTCACT
GCGGGACTTTAACCACTGAC -> CGGGACTTTAACCACTGACA
CTTAGGGGCCCGTTTTGCAC -> TTAGGGGCCCGTTTTGCACG
CGGTGAAACTAACAGTCAGG -> GGTGAAACTAACAGTCAGGG
ATAAAAAGGGACGTGTCGAT -> TAAAAAGGGACGTGTCGATA
GGGAGGCAGTGATATTAGCC -> GGAGGCAGTGATATTAGCCG
TAGTGAGGGCCTACCTCTTA -> AGTGAGGGCCTACCTCTTAA
CCTCAAGGAGTACACGATAA -> CTCAAGGAGTACACGATAAC
AAGCTACGCCAAGCGACTGA -> AGCTACGCCAAGCGACTGAG
TAGCACGGCATGCTTAACTT -> AGCACGGCATGCTTAACTTA
CCCCGCAGTTGGTCAGATTC -> CCCGCAGTTGGTCAGATTCA
CCATGACCCCGAAGCGCTTA -> CATGACCCCGAAGCGCTTAT
AAGTCTGAGCTGATTCCGGC -> AGTCTGAGCTGATTCCGGCT
AAATCCTTATACAGCACTTC -> AATCCTTATACAGCACTTCT
CCGGTGGTAAAGGCCGGGAA -> CGGTGGTAAAGGCCGGGAAG
ACTGGTAATACAGGCGGCGT -> CTGGTAATACAGGCGGCGTC
GGTCAGATTCACTAATGCCA -> GTCAGATTCACTAATGCCAA
GGCTCAGGTCCCTCTAGGAT -> GCTCAGGTCCCTCTAGGATG
CGGAGCTCCATAACGTAGGA -> GGAGCTCCATAACGTAGGAG
AAATGTTGTACATAAATACG -> AATGTTGTACATAAATACGG
CAGACAGTATGTTCTGCCTC -> AGACAGTATGTTCTGCCTCG
TCGCACGCCAAAAATTTCAG -> CGCACGCCAAAAATTTCAGT
TTGTACATAAATACGGGAAT -> TGTACATAAATACGGGAATC
TTCTCTTTATAATAAAAAGG -> TCTCTTTATAATAAAAAGGG
CACTAAAGACCCTGGACCTC -> ACTAAAGACCCTGGACCTCA
AAGCGACTGAGGACCTTCTT -> AGCGACTGAGGACCTTCTTT
GCACTTCTAGATTACGGTGA -> CACTTCTAGATTACGGTGAA
GCAGTTGGTCAGATTCACTA -> CAGTTGGTCAGATTCACTAA
ATAAATACGGGAATCACACG -> TAAATACGGGAATCACACGG
CAAGCGACTGAGGACCTTCT -> AAGCGACTGAGGACCTTCTT
GGCCCGTTTTGCACGCTAAT -> GCCCGTTTTGCACGCTAATG
CCGCGACGTATGGTTTTGGC -> CGCGACGTATGGTTTTGGCC
GTGGGCGAGGGAGGCAGTGA -> TGGGCGAGGGAGGCAGTGAT
CGCACACAACTTTCTTAATA -> GCACACAACTTTCTTAATAA
GATGAGGTCGTTTTCCCGGG -> ATGAGGTCGTTTTCCCGGGT
GCCAAAAATTTCAGTTTAAC -> CCAAAAATTTCAGTTTAACG
TCGGCGGGACTTTAACCACT -> CGGCGGGACTTTAACCACTG
CAGGCGGCGTCTGGTGGGCG -> AGGCGGCGTCTGGTGGGCGA
AAAGGTCCTACTCTTGCCAC -> AAGGTCCTACTCTTGCCACC
TCCGCGACGTATGGTTTTGG -> CCGCGACGTATGGTTTTGGC
ACCGGGTGTGACCTCAGAGT -> CCGGGTGTGACCTCAGAGTG
AGATTACGGTGAAACTAACA -> GATTACGGTGAAACTAACAG
CTTCTCTTTATAATAAAAAG -> TTCTCTTTATAATAAAAAGG
AGTGGCTGGCGGACTAAAAT -> GTGGCTGGCGGACTAAAATC
CATAGATGAGGTCGTTTTCC -> ATAGATGAGGTCGTTTTCCC
TCCATAGTCAGTATAATCGC -> CCATAGTCAGTATAATCGCC
AGAGTTGCGCCAGGTCATAC -> GAGTTGCGCCAGGTCATACC
GGACCTTCTTTGCTGCGTTG -> GACCTTCTTTGCTGCGTTGC
TTGGCCCCGAAACTCCCAGT -> TGGCCCCGAAACTCCCAGTG
ATGACCTAGGAAGGTGACTC -> TGACCTAGGAAGGTGACTCA
GTACCTGACTTCTCTTTATA -> TACCTGACTTCTCTTTATAA
AATAATCATAGATGAGGTCG -> ATAATCATAGATGAGGTCGT
ACTCTTGCCACCACGTTTTT -> CTCTTGCCACCACGTTTTTA
CCGTTTTGCACGCTAATGAC -> CGTTTTGCACGCTAATGACC
GTGAGGGCCTACCTCTTAAA -> TGAGGGCCTACCTCTTAAAG
AGGACCTTCTTTGCTGCGTT -> GGACCTTCTTTGCTGCGTTG
CGGGTGTGACCTCAGAGTGA -> GGGTGTGACCTCAGAGTGAC
CACTCCATGACCCCGAAGCG -> ACTCCATGACCCCGAAGCGC
CCCGAAACTCCCAGTGGCTG -> CCGAAACTCCCAGTGGCTGG
GATGCTCTTTTATTATAGGG -> ATGCTCTTTTATTATAGGGT
ACTCACTACCGGGTGTGACC -> CTCACTACCGGGTGTGACCT
TTGCGCCAGGTCATACCCTA -> TGCGCCAGGTCATACCCTAC
CTCCCAGTGGCTGGCGGACT -> TCCCAGTGGCTGGCGGACTA
GACTTTAACCACTGACATCG -> ACTTTAACCACTGACATCGA
GGCCGGGAAGCGTCGATACG -> GCCGGGAAGCGTCGATACGG
CATAAATACGGGAATCACAC -> ATAAATACGGGAATCACACG
ATAGATGAGGTCGTTTTCCC -> TAGATGAGGTCGTTTTCCCG
TACGGTGCTGACCTCGGAGC -> ACGGTGCTGACCTCGGAGCT
CCCCGAAGCGCTTATAGTTA -> CCCGAAGCGCTTATAGTTAA
ACGGTGCTGACCTCGGAGCT -> CGGTGCTGACCTCGGAGCTC
TCGTTTTCCCGGGTTCTTCC -> CGTTTTCCCGGGTTCTTCCA
GGGCGAGGGAGGCAGTGATA -> GGCGAGGGAGGCAGTGATAT
AGCTACGCCAAGCGACTGAG -> GCTACGCCAAGCGACTGAGG
AGTACACGATAACAAACTCA -> GTACACGATAACAAACTCAC
CCTACCCTAGGCTAGTGAGG -> CTACCCTAGGCTAGTGAGGG
TCTTTGCTGCGTTGCGCACA -> CTTTGCTGCGTTGCGCACAC
GGGACCGCGTGAGACAGACA -> GGACCGCGTGAGACAGACAG
GTTTTCCCGGGTTCTTCCAA -> TTTTCCCGGGTTCTTCCAAA
ATCCTATTAGTAGTATCCGC -> TCCTATTAGTAGTATCCGCA
AATCACACGGGACCGCGTGA -> ATCACACGGGACCGCGTGAG
GCCAGGTCATACCCTACCCT -> CCAGGTCATACCCTACCCTA
AGGAGTACACGATAACAAAC -> GGAGTACACGATAACAAACT
TGTACATAAATACGGGAATC -> GTACATAAATACGGGAATCA
AGCTGATTCCGGCTCAGGTC -> GCTGATTCCGGCTCAGGTCC
CCTTATACAGCACTTCTAGA -> CTTATACAGCACTTCTAGAT
AAGACATGGGGGTCATCCGG -> AGACATGGGGGTCATCCGGT
AGGATGCTCTTTTATTATAG -> GGATGCTCTTTTATTATAGG
ACGTAGGAGAGTTGCGCCAG -> CGTAGGAGAGTTGCGCCAGG
ATGTTGTACATAAATACGGG -> TGTTGTACATAAATACGGGA
TCAGGGCACTAAAGACCCTG -> CAGGGCACTAAAGACCCTGG
TTAAATCCTTATACAGCACT -> TAAATCCTTATACAGCACTT
AGTACCTGACTTCTCTTTAT -> GTACCTGACTTCTCTTTATA
GTCCTACTCTTGCCACCACG -> TCCTACTCTTGCCACCACGT
ATACAGGCGGCGTCTGGTGG -> TACAGGCGGCGTCTGGTGGG
GGGAAGCGTCGATACGGTGC -> GGAAGCGTCGATACGGTGCT
GATATTAGCCGTGTCGGGCT -> ATATTAGCCGTGTCGGGCTG
GAAACTAACAGTCAGGGCAC -> AAACTAACAGTCAGGGCACT
GCCAAGCGACTGAGGACCTT -> CCAAGCGACTGAGGACCTTC
TAGGAGAGTTGCGCCAGGTC -> AGGAGAGTTGCGCCAGGTCA
ACCTCTTAAAGCTACGCCAA -> CCTCTTAAAGCTACGCCAAG
ATACAGCACTTCTAGATTAC -> TACAGCACTTCTAGATTACG
AGTGATATTAGCCGTGTCGG -> GTGATATTAGCCGTGTCGGG
GAAGGTGACTCAGAGACTGC -> AAGGTGACTCAGAGACTGCA
GACTTCTCTTTATAATAAAA -> ACTTCTCTTTATAATAAAAA
CGGGACCGCGTGAGACAGAC -> GGGACCGCGTGAGACAGACA
TACCTGACTTCTCTTTATAA -> ACCTGACTTCTCTTTATAAT
TTCGTGTAAGTCTGAGCTGA -> TCGTGTAAGTCTGAGCTGAT
CCACTTATTATGTCTGGACC -> CACTTATTATGTCTGGACCA
CTTAAAGCTACGCCAAGCGA -> TTAAAGCTACGCCAAGCGAC
GAGGACCTTCTTTGCTGCGT -> AGGACCTTCTTTGCTGCGTT
CTCCATAACGTAGGAGAGTT -> TCCATAACGTAGGAGAGTTG
GGGAATCACACGGGACCGCG -> GGAATCACACGGGACCGCGT
ACGGCCGTTTCGTGTAAGTC -> CGGCCGTTTCGTGTAAGTCT
TCGTGTTTATCGGCGGGACT -> CGTGTTTATCGGCGGGACTT
ACGGCATGCTTAACTTAGGG -> CGGCATGCTTAACTTAGGGG
CTGGCGGACTAAAATCTAGG -> TGGCGGACTAAAATCTAGGT
GAGTACACGATAACAAACTC -> AGTACACGATAACAAACTCA
ATGCCTGAGTACCTGACTTC -> TGCCTGAGTACCTGACTTCT
ATCCGCACTCCATGACCCCG -> TCCGCACTCCATGACCCCGA
CAACTTTCTTAATAATCATA -> AACTTTCTTAATAATCATAG
GCGTAAAGGTCCTACTCTTG -> CGTAAAGGTCCTACTCTTGC
AGCGACTGAGGACCTTCTTT -> GCGACTGAGGACCTTCTTTG
GTTTTGCACGCTAATGACCT -> TTTTGCACGCTAATGACCTA
AAACTCACTACCGGGTGTGA -> AACTCACTACCGGGTGTGAC
CAAGGAGTACACGATAACAA -> AAGGAGTACACGATAACAAA
CTACCGGGTGTGACCTCAGA -> TACCGGGTGTGACCTCAGAG
CTGGCATGTCAATCGTGTTT -> TGGCATGTCAATCGTGTTTA
TTTAACCACTGACATCGACC -> TTAACCACTGACATCGACCC
CGGCGGGACTTTAACCACTG -> GGCGGGACTTTAACCACTGA
ACCTGACTTCTCTTTATAAT -> CCTGACTTCTCTTTATAATA
CAGAGTGACTCGTCCACTTA -> AGAGTGACTCGTCCACTTAT
TGTCGGGCTGGCATGTCAAT -> GTCGGGCTGGCATGTCAATC
CGTCGATACGGTGCTGACCT -> GTCGATACGGTGCTGACCTC
TTCTAGATTACGGTGAAACT -> TCTAGATTACGGTGAAACTA
GGGACGTGTCGATATCCTAT -> GGACGTGTCGATATCCTATT
AAAGGGACGTGTCGATATCC -> AAGGGACGTGTCGATATCCT
GTTGCGCCAGGTCATACCCT -> TTGCGCCAGGTCATACCCTA
TGCTGCGTTGCGCACACAAC -> GCTGCGTTGCGCACACAACT
CTCGGAGCTCCATAACGTAG -> TCGGAGCTCCATAACGTAGG
TCTTTATAATAAAAAGGGAC -> CTTTATAATAAAAAGGGACG
TCTGTAGATCTTAGCACGGC -> CTGTAGATCTTAGCACGGCA
CACACGGGACCGCGTGAGAC -> ACACGGGACCGCGTGAGACA
GGTGTGACCTCAGAGTGACT -> GTGTGACCTCAGAGTGACTC
GTTTTGGCCCCGAAACTCCC -> TTTTGGCCCCGAAACTCCCA
TGGACCTCAAGGAGTACACG -> GGACCTCAAGGAGTACACGA
CGTGTCGGGCTGGCATGTCA -> GTGTCGGGCTGGCATGTCAA
TAAAGACCCTGGACCTCAAG -> AAAGACCCTGGACCTCAAGG
TCGATATCCTATTCTGTAGA -> CGATATCCTATTCTGTAGAT
TTGCGCACACAACTTTCTTA -> TGCGCACACAACTTTCTTAA
TATTTGCGTCCGATGCCTGA -> ATTTGCGTCCGATGCCTGAG
TGGACCAGTGTTCCGCGACG -> GGACCAGTGTTCCGCGACGT
AGTTGCGCCAGGTCATACCC -> GTTGCGCCAGGTCATACCCT
TGGCGGACTAAAATCTAGGT -> GGCGGACTAAAATCTAGGTC
ACATCGACCCCGCAGTTGGT -> CATCGACCCCGCAGTTGGTC
TCCCAGTGGCTGGCGGACTA -> CCCAGTGGCTGGCGGACTAA
TGTTCTGCCTCGCTCTGATA -> GTTCTGCCTCGCTCTGATAA
AACAGTCAGGGCACTAAAGA -> ACAGTCAGGGCACTAAAGAC
TCGGAGCTCCATAACGTAGG -> CGGAGCTCCATAACGTAGGA
GTCAGGGCACTAAAGACCCT -> TCAGGGCACTAAAGACCCTG
TCAGATTCACTAATGCCAAA -> CAGATTCACTAATGCCAAAT
GCTGCGTTGCGCACACAACT -> CTGCGTTGCGCACACAACTT
GACTGCAAAGCCATACGCGT -> ACTGCAAAGCCATACGCGTA
CCCGCAGTTGGTCAGATTCA -> CCGCAGTTGGTCAGATTCAC
GCGACTGAGGACCTTCTTTG -> CGACTGAGGACCTTCTTTGC
CGCGTAAAGGTCCTACTCTT -> GCGTAAAGGTCCTACTCTTG
TAACGTAGGAGAGTTGCGCC -> AACGTAGGAGAGTTGCGCCA
TGCGTTGCGCACACAACTTT -> GCGTTGCGCACACAACTTTC
CATCGACCCCGCAGTTGGTC -> ATCGACCCCGCAGTTGGTCA
GCCTACCTCTTAAAGCTACG -> CCTACCTCTTAAAGCTACGC
GGTGCTGACCTCGGAGCTCC -> GTGCTGACCTCGGAGCTCCA
ACAGACAGTATGTTCTGCCT -> CAGACAGTATGTTCTGCCTC
GTGATATTAGCCGTGTCGGG -> TGATATTAGCCGTGTCGGGC
TCGTGTAAGTCTGAGCTGAT -> CGTGTAAGTCTGAGCTGATT
CGGACTAAAATCTAGGTCGC -> GGACTAAAATCTAGGTCGCA
CAGATTCACTAATGCCAAAT -> AGATTCACTAATGCCAAATG
GAGGGAGGCAGTGATATTAG -> AGGGAGGCAGTGATATTAGC
CGGGACTTTAACCACTGACA -> GGGACTTTAACCACTGACAT
TCCGCACTCCATGACCCCGA -> CCGCACTCCATGACCCCGAA
CTACGCCAAGCGACTGAGGA -> TACGCCAAGCGACTGAGGAC
CGTCCACTTATTATGTCTGG -> GTCCACTTATTATGTCTGGA
GTTCTGCCTCGCTCTGATAA -> TTCTGCCTCGCTCTGATAAG
CATACCCTACCCTAGGCTAG -> ATACCCTACCCTAGGCTAGT
TAGTAGTATCCGCACTCCAT -> AGTAGTATCCGCACTCCATG
TGTTTATCGGCGGGACTTTA -> GTTTATCGGCGGGACTTTAA
GATTCCGGCTCAGGTCCCTC -> ATTCCGGCTCAGGTCCCTCT
GGCGGACTAAAATCTAGGTC -> GCGGACTAAAATCTAGGTCG
GCACTCCATGACCCCGAAGC -> CACTCCATGACCCCGAAGCG
GGGTTCTTCCAAATCCTATT -> GGTTCTTCCAAATCCTATTA
GGGCCTACCTCTTAAAGCTA -> GGCCTACCTCTTAAAGCTAC
TCAATCGTGTTTATCGGCGG -> CAATCGTGTTTATCGGCGGG
AACGTAGGAGAGTTGCGCCA -> ACGTAGGAGAGTTGCGCCAG
AACAAACTCACTACCGGGTG -> ACAAACTCACTACCGGGTGT
GCGTCTGGTGGGCGAGGGAG -> CGTCTGGTGGGCGAGGGAGG
CTAGTGAGGGCCTACCTCTT -> TAGTGAGGGCCTACCTCTTA
TGAGGGCCTACCTCTTAAAG -> GAGGGCCTACCTCTTAAAGC
TTTCTTAATAATCATAGATG -> TTCTTAATAATCATAGATGA
AGGTCCCTCTAGGATGCTCT -> GGTCCCTCTAGGATGCTCTT
TTTGCGTCCGATGCCTGAGT -> TTGCGTCCGATGCCTGAGTA
GTAGATCTTAGCACGGCATG -> TAGATCTTAGCACGGCATGC
GACCCTGGACCTCAAGGAGT -> ACCCTGGACCTCAAGGAGTA
GCTACGCCAAGCGACTGAGG -> CTACGCCAAGCGACTGAGGA
AGATCTTAGCACGGCATGCT -> GATCTTAGCACGGCATGCTT
AAGCGTCGATACGGTGCTGA -> AGCGTCGATACGGTGCTGAC
TGACTTCTCTTTATAATAAA -> GACTTCTCTTTATAATAAAA
GTGTGACCTCAGAGTGACTC -> TGTGACCTCAGAGTGACTCG
TCGTCCACTTATTATGTCTG -> CGTCCACTTATTATGTCTGG
GATATCCTATTCTGTAGATC -> ATATCCTATTCTGTAGATCT
CTGGTGGGCGAGGGAGGCAG -> TGGTGGGCGAGGGAGGCAGT
ATAATCATAGATGAGGTCGT -> TAATCATAGATGAGGTCGTT
CTCTTAAAGCTACGCCAAGC -> TCTTAAAGCTACGCCAAGCG
GTCTGAGCTGATTCCGGCTC -> TCTGAGCTGATTCCGGCTCA
TAGGGGCCCGTTTTGCACGC -> AGGGGCCCGTTTTGCACGCT
GGTGACTCAGAGACTGCAAA -> GTGACTCAGAGACTGCAAAG
GGGGGTCATCCGGTGGTAAA -> GGGGTCATCCGGTGGTAAAG
GGCATGCTTAACTTAGGGGC -> GCATGCTTAACTTAGGGGCC
TAAATCCTTATACAGCACTT -> AAATCCTTATACAGCACTTC
CTGAGCTGATTCCGGCTCAG -> TGAGCTGATTCCGGCTCAGG
GACCCCGCAGTTGGTCAGAT -> ACCCCGCAGTTGGTCAGATT
ATGTCAATCGTGTTTATCGG -> TGTCAATCGTGTTTATCGGC
CACGGGACCGCGTGAGACAG -> ACGGGACCGCGTGAGACAGA
GTATCCGCACTCCATGACCC -> TATCCGCACTCCATGACCCC
AGGAGAGTTGCGCCAGGTCA -> GGAGAGTTGCGCCAGGTCAT
GTCATACCCTACCCTAGGCT -> TCATACCCTACCCTAGGCTA
GGCGGCGTCTGGTGGGCGAG -> GCGGCGTCTGGTGGGCGAGG
TCATAGATGAGGTCGTTTTC -> CATAGATGAGGTCGTTTTCC
GTAAGTCTGAGCTGATTCCG -> TAAGTCTGAGCTGATTCCGG
AATCGTGTTTATCGGCGGGA -> ATCGTGTTTATCGGCGGGAC
AATACAGGCGGCGTCTGGTG -> ATACAGGCGGCGTCTGGTGG
TCTGCCTCGCTCTGATAAGA -> CTGCCTCGCTCTGATAAGAC
CTTTATAATAAAAAGGGACG -> TTTATAATAAAAAGGGACGT
GATAACAAACTCACTACCGG -> ATAACAAACTCACTACCGGG
GCATGCTTAACTTAGGGGCC -> CATGCTTAACTTAGGGGCCC
TTAACTTAGGGGCCCGTTTT -> TAACTTAGGGGCCCGTTTTG
TACAGGCGGCGTCTGGTGGG -> ACAGGCGGCGTCTGGTGGGC
CGACTGAGGACCTTCTTTGC -> GACTGAGGACCTTCTTTGCT
AACCACTGACATCGACCCCG -> ACCACTGACATCGACCCCGC
GAGACTGCAAAGCCATACGC -> AGACTGCAAAGCCATACGCG
CGGCGTCTGGTGGGCGAGGG -> GGCGTCTGGTGGGCGAGGGA
TACCCTACCCTAGGCTAGTG -> ACCCTACCCTAGGCTAGTGA
CTCACTACCGGGTGTGACCT -> TCACTACCGGGTGTGACCTC
TCAAGGAGTACACGATAACA -> CAAGGAGTACACGATAACAA
GAGTTGCGCCAGGTCATACC -> AGTTGCGCCAGGTCATACCC
AAATCCTATTAGTAGTATCC -> AATCCTATTAGTAGTATCCG
TGGTCAGATTCACTAATGCC -> GGTCAGATTCACTAATGCCA
TTTATCGGCGGGACTTTAAC -> TTATCGGCGGGACTTTAACC
CGTAGGAGAGTTGCGCCAGG -> GTAGGAGAGTTGCGCCAGGT
AATCATAGATGAGGTCGTTT -> ATCATAGATGAGGTCGTTTT
GTTTCGTGTAAGTCTGAGCT -> TTTCGTGTAAGTCTGAGCTG
ATGCTCTTTTATTATAGGGT -> TGCTCTTTTATTATAGGGTC
TACGCGTAAAGGTCCTACTC -> ACGCGTAAAGGTCCTACTCT
TAAAGGTCCTACTCTTGCCA -> AAAGGTCCTACTCTTGCCAC
ATCCTATTCTGTAGATCTTA -> TCCTATTCTGTAGATCTTAG
GCTCAGGTCCCTCTAGGATG -> CTCAGGTCCCTCTAGGATGC
AGTATCCGCACTCCATGACC -> GTATCCGCACTCCATGACCC
TAGGATGCTCTTTTATTATA -> AGGATGCTCTTTTATTATAG
ATTCTGTAGATCTTAGCACG -> TTCTGTAGATCTTAGCACGG
CGCTCTGATAAGACATGGGG -> GCTCTGATAAGACATGGGGG
CACGCCAAAAATTTCAGTTT -> ACGCCAAAAATTTCAGTTTA
TGACCTAGGAAGGTGACTCA -> GACCTAGGAAGGTGACTCAG
TCTTGCCACCACGTTTTTAA -> CTTGCCACCACGTTTTTAAC
TTCTTTGCTGCGTTGCGCAC -> TCTTTGCTGCGTTGCGCACA
ATCGGCGGGACTTTAACCAC -> TCGGCGGGACTTTAACCACT
AGGGCACTAAAGACCCTGGA -> GGGCACTAAAGACCCTGGAC
CACACAACTTTCTTAATAAT -> ACACAACTTTCTTAATAATC
CGCCAAGCGACTGAGGACCT -> GCCAAGCGACTGAGGACCTT
TATTAGTAGTATCCGCACTC -> ATTAGTAGTATCCGCACTCC
GGCGTCTGGTGGGCGAGGGA -> GCGTCTGGTGGGCGAGGGAG
ACAGTCAGGGCACTAAAGAC -> CAGTCAGGGCACTAAAGACC
GAGAGTTGCGCCAGGTCATA -> AGAGTTGCGCCAGGTCATAC
CGCTTATAGTTAAATCCTTA -> GCTTATAGTTAAATCCTTAT
CTGCGTTGCGCACACAACTT -> TGCGTTGCGCACACAACTTT
AGAGACTGCAAAGCCATACG -> GAGACTGCAAAGCCATACGC
CTGACTTCTCTTTATAATAA -> TGACTTCTCTTTATAATAAA
GGATGCTCTTTTATTATAGG -> GATGCTCTTTTATTATAGGG
CAGTATGTTCTGCCTCGCTC -> AGTATGTTCTGCCTCGCTCT
CGTGTAAGTCTGAGCTGATT -> GTGTAAGTCTGAGCTGATTC
TATTAGCCGTGTCGGGCTGG -> ATTAGCCGTGTCGGGCTGGC
CATAGTCAGTATAATCGCCA -> ATAGTCAGTATAATCGCCAA
GTCTGGTGGGCGAGGGAGGC -> TCTGGTGGGCGAGGGAGGCA
GCCGTGTCGGGCTGGCATGT -> CCGTGTCGGGCTGGCATGTC
TTATAGTTAAATCCTTATAC -> TATAGTTAAATCCTTATACA
GACCTCAAGGAGTACACGAT -> ACCTCAAGGAGTACACGATA
GTGAGACAGACAGTATGTTC -> TGAGACAGACAGTATGTTCT
CGTGTTTATCGGCGGGACTT -> GTGTTTATCGGCGGGACTTT
CGGGAATCACACGGGACCGC -> GGGAATCACACGGGACCGCG
TCCTTATACAGCACTTCTAG -> CCTTATACAGCACTTCTAGA
GGCATGTCAATCGTGTTTAT -> GCATGTCAATCGTGTTTATC
ACTTCTCTTTATAATAAAAA -> CTTCTCTTTATAATAAAAAG
TTTGGCCCCGAAACTCCCAG -> TTGGCCCCGAAACTCCCAGT
CGGCCGTTTCGTGTAAGTCT -> GGCCGTTTCGTGTAAGTCTG
CGATATCCTATTCTGTAGAT -> GATATCCTATTCTGTAGATC
GACCTAGGAAGGTGACTCAG -> ACCTAGGAAGGTGACTCAGA
TCTGGTGGGCGAGGGAGGCA -> CTGGTGGGCGAGGGAGGCAG
GAGTACCTGACTTCTCTTTA -> AGTACCTGACTTCTCTTTAT
GCGTATTTGCGTCCGATGCC -> CGTATTTGCGTCCGATGCCT
TCACTAATGCCAAATGTTGT -> CACTAATGCCAAATGTTGTA
AAAATCTAGGTCGCACGCCA -> AAATCTAGGTCGCACGCCAA
ATAGTCAGTATAATCGCCAA -> TAGTCAGTATAATCGCCAAA
AACTTAGGGGCCCGTTTTGC -> ACTTAGGGGCCCGTTTTGCA
CCGTTTCGTGTAAGTCTGAG -> CGTTTCGTGTAAGTCTGAGC
GCTGATTCCGGCTCAGGTCC -> CTGATTCCGGCTCAGGTCCC
GTTCCGCGACGTATGGTTTT -> TTCCGCGACGTATGGTTTTG
ATCCTTATACAGCACTTCTA -> TCCTTATACAGCACTTCTAG
ATTCACTAATGCCAAATGTT -> TTCACTAATGCCAAATGTTG
GTGACCTCAGAGTGACTCGT -> TGACCTCAGAGTGACTCGTC
CCTCTAGGATGCTCTTTTAT -> CTCTAGGATGCTCTTTTATT
CTGTAGATCTTAGCACGGCA -> TGTAGATCTTAGCACGGCAT
TTTTGGCCCCGAAACTCCCA -> TTTGGCCCCGAAACTCCCAG
CGTTGCGCACACAACTTTCT -> GTTGCGCACACAACTTTCTT
GGGACTTTAACCACTGACAT -> GGACTTTAACCACTGACATC
CCGTGTCGGGCTGGCATGTC -> CGTGTCGGGCTGGCATGTCA
TAGATGAGGTCGTTTTCCCG -> AGATGAGGTCGTTTTCCCGG
TCTAGGTCGCACGCCAAAAA -> CTAGGTCGCACGCCAAAAAT
CCATAACGTAGGAGAGTTGC -> CATAACGTAGGAGAGTTGCG
ATTATAGGGTCCATAGTCAG -> TTATAGGGTCCATAGTCAGT
CTGGACCAGTGTTCCGCGAC -> TGGACCAGTGTTCCGCGACG
CTTTTATTATAGGGTCCATA -> TTTTATTATAGGGTCCATAG
TAATAATCATAGATGAGGTC -> AATAATCATAGATGAGGTCG
TTTATTATAGGGTCCATAGT -> TTATTATAGGGTCCATAGTC
TATCGGCGGGACTTTAACCA -> ATCGGCGGGACTTTAACCAC
ACGCCAAAAATTTCAGTTTA -> CGCCAAAAATTTCAGTTTAA
TTGCACGCTAATGACCTAGG -> TGCACGCTAATGACCTAGGA
GCCCGTTTTGCACGCTAATG -> CCCGTTTTGCACGCTAATGA
AATAAAAAGGGACGTGTCGA -> ATAAAAAGGGACGTGTCGAT
TGATAAGACATGGGGGTCAT -> GATAAGACATGGGGGTCATC
TAACCACTGACATCGACCCC -> AACCACTGACATCGACCCCG
TGCCTGAGTACCTGACTTCT -> GCCTGAGTACCTGACTTCTC
ACGGGACCGCGTGAGACAGA -> CGGGACCGCGTGAGACAGAC
TCTAGGATGCTCTTTTATTA -> CTAGGATGCTCTTTTATTAT
TGCGCCAGGTCATACCCTAC -> GCGCCAGGTCATACCCTACC
CGCACGCCAAAAATTTCAGT -> GCACGCCAAAAATTTCAGTT
GCTGGCATGTCAATCGTGTT -> CTGGCATGTCAATCGTGTTT
TGATTCCGGCTCAGGTCCCT -> GATTCCGGCTCAGGTCCCTC
TGATATTAGCCGTGTCGGGC -> GATATTAGCCGTGTCGGGCT
TGTCGATATCCTATTCTGTA -> GTCGATATCCTATTCTGTAG
TAGATCTTAGCACGGCATGC -> AGATCTTAGCACGGCATGCT
AAAGACCCTGGACCTCAAGG -> AAGACCCTGGACCTCAAGGA
GGCGGGACTTTAACCACTGA -> GCGGGACTTTAACCACTGAC
AGATGAGGTCGTTTTCCCGG -> GATGAGGTCGTTTTCCCGGG
TATGGTTTTGGCCCCGAAAC -> ATGGTTTTGGCCCCGAAACT
AATCTAGGTCGCACGCCAAA -> ATCTAGGTCGCACGCCAAAA
ACTACCGGGTGTGACCTCAG -> CTACCGGGTGTGACCTCAGA
GTAAAGGTCCTACTCTTGCC -> TAAAGGTCCTACTCTTGCCA
TTTTTAACTGGTAATACAGG -> TTTTAACTGGTAATACAGGC
ATGCTTAACTTAGGGGCCCG -> TGCTTAACTTAGGGGCCCGT
TTATTATGTCTGGACCAGTG -> TATTATGTCTGGACCAGTGT
GGACGTGTCGATATCCTATT -> GACGTGTCGATATCCTATTC
AGGGAGGCAGTGATATTAGC -> GGGAGGCAGTGATATTAGCC
TATCCGCACTCCATGACCCC -> ATCCGCACTCCATGACCCCG
CTTAACTTAGGGGCCCGTTT -> TTAACTTAGGGGCCCGTTTT
TTCCAAATCCTATTAGTAGT -> TCCAAATCCTATTAGTAGTA
GCTCTGATAAGACATGGGGG -> CTCTGATAAGACATGGGGGT
GGTCCTACTCTTGCCACCAC -> GTCCTACTCTTGCCACCACG
CCGGGTTCTTCCAAATCCTA -> CGGGTTCTTCCAAATCCTAT
CGTCTGGTGGGCGAGGGAGG -> GTCTGGTGGGCGAGGGAGGC
CAGGTCATACCCTACCCTAG -> AGGTCATACCCTACCCTAGG
CTCTTTTATTATAGGGTCCA -> TCTTTTATTATAGGGTCCAT
TGACCTCAGAGTGACTCGTC -> GACCTCAGAGTGACTCGTCC
ACCCTACCCTAGGCTAGTGA -> CCCTACCCTAGGCTAGTGAG
TGCGTCCGATGCCTGAGTAC -> GCGTCCGATGCCTGAGTACC
TAACTGGTAATACAGGCGGC -> AACTGGTAATACAGGCGGCG
CCAGGTCATACCCTACCCTA -> CAGGTCATACCCTACCCTAG
GTGGCTGGCGGACTAAAATC -> TGGCTGGCGGACTAAAATCT
GTACACGATAACAAACTCAC -> TACACGATAACAAACTCACT
GCCACCACGTTTTTAACTGG -> CCACCACGTTTTTAACTGGT
CTTAATAATCATAGATGAGG -> TTAATAATCATAGATGAGGT
GGCCCCGAAACTCCCAGTGG -> GCCCCGAAACTCCCAGTGGC
CCAAATCCTATTAGTAGTAT -> CAAATCCTATTAGTAGTATC
TACAGCACTTCTAGATTACG -> ACAGCACTTCTAGATTACGG
GCTTAACTTAGGGGCCCGTT -> CTTAACTTAGGGGCCCGTTT
CGAAACTCCCAGTGGCTGGC -> GAAACTCCCAGTGGCTGGCG
GACGTGTCGATATCCTATTC -> ACGTGTCGATATCCTATTCT
TTACGGTGAAACTAACAGTC -> TACGGTGAAACTAACAGTCA
TCTCTTTATAATAAAAAGGG -> CTCTTTATAATAAAAAGGGA
TGAGGACCTTCTTTGCTGCG -> GAGGACCTTCTTTGCTGCGT
GTCGATATCCTATTCTGTAG -> TCGATATCCTATTCTGTAGA
CTAGGTCGCACGCCAAAAAT -> TAGGTCGCACGCCAAAAATT
ATGGGGGTCATCCGGTGGTA -> TGGGGGTCATCCGGTGGTAA
TGGTAATACAGGCGGCGTCT -> GGTAATACAGGCGGCGTCTG
GATTCACTAATGCCAAATGT -> ATTCACTAATGCCAAATGTT
TTAGCCGTGTCGGGCTGGCA -> TAGCCGTGTCGGGCTGGCAT
TACCGGGTGTGACCTCAGAG -> ACCGGGTGTGACCTCAGAGT
CGCACTCCATGACCCCGAAG -> GCACTCCATGACCCCGAAGC
ACACGGGACCGCGTGAGACA -> CACGGGACCGCGTGAGACAG
CAGAGACTGCAAAGCCATAC -> AGAGACTGCAAAGCCATACG
TCAGTATAATCGCCAAATAT -> CAGTATAATCGCCAAATATA
GGTCCATAGTCAGTATAATC -> GTCCATAGTCAGTATAATCG
GCACGCTAATGACCTAGGAA -> CACGCTAATGACCTAGGAAG
CTTCTTTGCTGCGTTGCGCA -> TTCTTTGCTGCGTTGCGCAC
GTCAGTATAATCGCCAAATA -> TCAGTATAATCGCCAAATAT
TAATCATAGATGAGGTCGTT -> AATCATAGATGAGGTCGTTT
CCTACCTCTTAAAGCTACGC -> CTACCTCTTAAAGCTACGCC
AAACTCCCAGTGGCTGGCGG -> AACTCCCAGTGGCTGGCGGA
TCCACTTATTATGTCTGGAC -> CCACTTATTATGTCTGGACC
GTGTAAGTCTGAGCTGATTC -> TGTAAGTCTGAGCTGATTCC
AATGACCTAGGAAGGTGACT -> ATGACCTAGGAAGGTGACTC
CCTGAGTACCTGACTTCTCT -> CTGAGTACCTGACTTCTCTT
TGACCCCGAAGCGCTTATAG -> GACCCCGAAGCGCTTATAGT
TGAGCTGATTCCGGCTCAGG -> GAGCTGATTCCGGCTCAGGT
CCAAATGTTGTACATAAATA -> CAAATGTTGTACATAAATAC
GAATCACACGGGACCGCGTG -> AATCACACGGGACCGCGTGA
CATACGCGTAAAGGTCCTAC -> ATACGCGTAAAGGTCCTACT
GGCTGGCATGTCAATCGTGT -> GCTGGCATGTCAATCGTGTT
ACTAACAGTCAGGGCACTAA -> CTAACAGTCAGGGCACTAAA
AATGCCAAATGTTGTACATA -> ATGCCAAATGTTGTACATAA
GACTCAGAGACTGCAAAGCC -> ACTCAGAGACTGCAAAGCCA
TCTGGACCAGTGTTCCGCGA -> CTGGACCAGTGTTCCGCGAC
CAAATCCTATTAGTAGTATC -> AAATCCTATTAGTAGTATCC
CTGCAAAGCCATACGCGTAA -> TGCAAAGCCATACGCGTAAA
GGTGAAACTAACAGTCAGGG -> GTGAAACTAACAGTCAGGGC
GAGCTCCATAACGTAGGAGA -> AGCTCCATAACGTAGGAGAG
CTGATAAGACATGGGGGTCA -> TGATAAGACATGGGGGTCAT
GGTGGGCGAGGGAGGCAGTG -> GTGGGCGAGGGAGGCAGTGA
GCAAAGCCATACGCGTAAAG -> CAAAGCCATACGCGTAAAGG
CCGCGTGAGACAGACAGTAT -> CGCGTGAGACAGACAGTATG
TGTCTGGACCAGTGTTCCGC -> GTCTGGACCAGTGTTCCGCG
GCACGCCAAAAATTTCAGTT -> CACGCCAAAAATTTCAGTTT
CCAAAAATTTCAGTTTAACG -> CAAAAATTTCAGTTTAACGG
GGAAGGTGACTCAGAGACTG -> GAAGGTGACTCAGAGACTGC
CTCAAGGAGTACACGATAAC -> TCAAGGAGTACACGATAACA
AGTCAGGGCACTAAAGACCC -> GTCAGGGCACTAAAGACCCT
GACCGCGTGAGACAGACAGT -> ACCGCGTGAGACAGACAGTA
ACGCCAAGCGACTGAGGACC -> CGCCAAGCGACTGAGGACCT
ATGTCTGGACCAGTGTTCCG -> TGTCTGGACCAGTGTTCCGC
TATCCTATTCTGTAGATCTT -> ATCCTATTCTGTAGATCTTA
CGTGAGACAGACAGTATGTT -> GTGAGACAGACAGTATGTTC
CAGGTCCCTCTAGGATGCTC -> AGGTCCCTCTAGGATGCTCT
TGGCATGTCAATCGTGTTTA -> GGCATGTCAATCGTGTTTAT
AGGAAGGTGACTCAGAGACT -> GGAAGGTGACTCAGAGACTG
GCGAGGGAGGCAGTGATATT -> CGAGGGAGGCAGTGATATTA
TCACACGGGACCGCGTGAGA -> CACACGGGACCGCGTGAGAC
CGGTGGTAAAGGCCGGGAAG -> GGTGGTAAAGGCCGGGAAGC
TACGGGAATCACACGGGACC -> ACGGGAATCACACGGGACCG
TTATACAGCACTTCTAGATT -> TATACAGCACTTCTAGATTA
TCCTACTCTTGCCACCACGT -> CCTACTCTTGCCACCACGTT
TGTTCCGCGACGTATGGTTT -> GTTCCGCGACGTATGGTTTT
GTGACTCAGAGACTGCAAAG -> TGACTCAGAGACTGCAAAGC
ACCTAGGAAGGTGACTCAGA -> CCTAGGAAGGTGACTCAGAG
GCCTGAGTACCTGACTTCTC -> CCTGAGTACCTGACTTCTCT
TGTCAATCGTGTTTATCGGC -> GTCAATCGTGTTTATCGGCG
CCTAGGAAGGTGACTCAGAG -> CTAGGAAGGTGACTCAGAGA
GGTGGTAAAGGCCGGGAAGC -> GTGGTAAAGGCCGGGAAGCG
CATAACGTAGGAGAGTTGCG -> ATAACGTAGGAGAGTTGCGC
AAACTAACAGTCAGGGCACT -> AACTAACAGTCAGGGCACTA
GCACTAAAGACCCTGGACCT -> CACTAAAGACCCTGGACCTC
ACGCTAATGACCTAGGAAGG -> CGCTAATGACCTAGGAAGGT
TCGCTCTGATAAGACATGGG -> CGCTCTGATAAGACATGGGG
TCTAGATTACGGTGAAACTA -> CTAGATTACGGTGAAACTAA
GTGTTTATCGGCGGGACTTT -> TGTTTATCGGCGGGACTTTA
GAGACAGACAGTATGTTCTG -> AGACAGACAGTATGTTCTGC
ACTTTAACCACTGACATCGA -> CTTTAACCACTGACATCGAC
TGCCTCGCTCTGATAAGACA -> GCCTCGCTCTGATAAGACAT
CCCGGGTTCTTCCAAATCCT -> CCGGGTTCTTCCAAATCCTA
AGACAGACAGTATGTTCTGC -> GACAGACAGTATGTTCTGCC
GGAGCTCCATAACGTAGGAG -> GAGCTCCATAACGTAGGAGA
TAGGAAGGTGACTCAGAGAC -> AGGAAGGTGACTCAGAGACT
ATGGTTTTGGCCCCGAAACT -> TGGTTTTGGCCCCGAAACTC
GTCAGATTCACTAATGCCAA -> TCAGATTCACTAATGCCAAA
ATATCCTATTCTGTAGATCT -> TATCCTATTCTGTAGATCTT
ACTTATTATGTCTGGACCAG -> CTTATTATGTCTGGACCAGT
TTTAACTGGTAATACAGGCG -> TTAACTGGTAATACAGGCGG
TCTGATAAGACATGGGGGTC -> CTGATAAGACATGGGGGTCA
GTAATACAGGCGGCGTCTGG -> TAATACAGGCGGCGTCTGGT
ATCACACGGGACCGCGTGAG -> TCACACGGGACCGCGTGAGA
AGTATGTTCTGCCTCGCTCT -> GTATGTTCTGCCTCGCTCTG
TTTATAATAAAAAGGGACGT -> TTATAATAAAAAGGGACGTG
TAAAGCTACGCCAAGCGACT -> AAAGCTACGCCAAGCGACTG
GCCGTTTCGTGTAAGTCTGA -> CCGTTTCGTGTAAGTCTGAG
GGCCGTTTCGTGTAAGTCTG -> GCCGTTTCGTGTAAGTCTGA
CCTACTCTTGCCACCACGTT -> CTACTCTTGCCACCACGTTT
TTGCCACCACGTTTTTAACT -> TGCCACCACGTTTTTAACTG
CCCTGGACCTCAAGGAGTAC -> CCTGGACCTCAAGGAGTACA
AGATTCACTAATGCCAAATG -> GATTCACTAATGCCAAATGT
CAGTGGCTGGCGGACTAAAA -> AGTGGCTGGCGGACTAAAAT
ACCCTGGACCTCAAGGAGTA -> CCCTGGACCTCAAGGAGTAC
ATAACAAACTCACTACCGGG -> TAACAAACTCACTACCGGGT
TGTGACCTCAGAGTGACTCG -> GTGACCTCAGAGTGACTCGT
CTTCTAGATTACGGTGAAAC -> TTCTAGATTACGGTGAAACT
ACGTGTCGATATCCTATTCT -> CGTGTCGATATCCTATTCTG
ATCTTAGCACGGCATGCTTA -> TCTTAGCACGGCATGCTTAA
GTCGCACGCCAAAAATTTCA -> TCGCACGCCAAAAATTTCAG
CGACCCCGCAGTTGGTCAGA -> GACCCCGCAGTTGGTCAGAT
CCAGTGGCTGGCGGACTAAA -> CAGTGGCTGGCGGACTAAAA
TCATCCGGTGGTAAAGGCCG -> CATCCGGTGGTAAAGGCCGG
CCGCACTCCATGACCCCGAA -> CGCACTCCATGACCCCGAAG
TGACTCGTCCACTTATTATG -> GACTCGTCCACTTATTATGT
AGCACGGCATGCTTAACTTA -> GCACGGCATGCTTAACTTAG
AGACTGCAAAGCCATACGCG -> GACTGCAAAGCCATACGCGT
ACTTAGGGGCCCGTTTTGCA -> CTTAGGGGCCCGTTTTGCAC
AGGTCGCACGCCAAAAATTT -> GGTCGCACGCCAAAAATTTC
CGCCAAAAATTTCAGTTTAA -> GCCAAAAATTTCAGTTTAAC
GAAACTCCCAGTGGCTGGCG -> AAACTCCCAGTGGCTGGCGG
ATACGCGTAAAGGTCCTACT -> TACGCGTAAAGGTCCTACTC
TCCATAACGTAGGAGAGTTG -> CCATAACGTAGGAGAGTTGC
TGGGGGTCATCCGGTGGTAA -> GGGGGTCATCCGGTGGTAAA
CCCCGAAACTCCCAGTGGCT -> CCCGAAACTCCCAGTGGCTG
ATAACGTAGGAGAGTTGCGC -> TAACGTAGGAGAGTTGCGCC
GACATGGGGGTCATCCGGTG -> ACATGGGGGTCATCCGGTGG
CGAGGGAGGCAGTGATATTA -> GAGGGAGGCAGTGATATTAG
GGTTCTTCCAAATCCTATTA -> GTTCTTCCAAATCCTATTAG
TACATAAATACGGGAATCAC -> ACATAAATACGGGAATCACA
TTGCTGCGTTGCGCACACAA -> TGCTGCGTTGCGCACACAAC
AACTCACTACCGGGTGTGAC -> ACTCACTACCGGGTGTGACC
AGCCGTGTCGGGCTGGCATG -> GCCGTGTCGGGCTGGCATGT
GGCAGTGATATTAGCCGTGT -> GCAGTGATATTAGCCGTGTC
CACTACCGGGTGTGACCTCA -> ACTACCGGGTGTGACCTCAG
TTCCGCGACGTATGGTTTTG -> TCCGCGACGTATGGTTTTGG
TTAACCACTGACATCGACCC -> TAACCACTGACATCGACCCC
AGTCAGTATAATCGCCAAAT -> GTCAGTATAATCGCCAAATA
CAGGGCACTAAAGACCCTGG -> AGGGCACTAAAGACCCTGGA
CTTAGCACGGCATGCTTAAC -> TTAGCACGGCATGCTTAACT
TAAGTCTGAGCTGATTCCGG -> AAGTCTGAGCTGATTCCGGC
TTTCGTGTAAGTCTGAGCTG -> TTCGTGTAAGTCTGAGCTGA
GTGCTGACCTCGGAGCTCCA -> TGCTGACCTCGGAGCTCCAT
GGACCAGTGTTCCGCGACGT -> GACCAGTGTTCCGCGACGTA
ATGAGGTCGTTTTCCCGGGT -> TGAGGTCGTTTTCCCGGGTT
AGAGTGACTCGTCCACTTAT -> GAGTGACTCGTCCACTTATT
TACGCCAAGCGACTGAGGAC -> ACGCCAAGCGACTGAGGACC
GTTTTTAACTGGTAATACAG -> TTTTTAACTGGTAATACAGG
GCATGTCAATCGTGTTTATC -> CATGTCAATCGTGTTTATCG
GCTTATAGTTAAATCCTTAT -> CTTATAGTTAAATCCTTATA
ACTTTCTTAATAATCATAGA -> CTTTCTTAATAATCATAGAT
CGTTTTCCCGGGTTCTTCCA -> GTTTTCCCGGGTTCTTCCAA
AGCTCCATAACGTAGGAGAG -> GCTCCATAACGTAGGAGAGT
CTTCCAAATCCTATTAGTAG -> TTCCAAATCCTATTAGTAGT
CGGGTTCTTCCAAATCCTAT -> GGGTTCTTCCAAATCCTATT
AACGGCCGTTTCGTGTAAGT -> ACGGCCGTTTCGTGTAAGTC
GACGTATGGTTTTGGCCCCG -> ACGTATGGTTTTGGCCCCGA
TCGATACGGTGCTGACCTCG -> CGATACGGTGCTGACCTCGG
GCGCCAGGTCATACCCTACC -> CGCCAGGTCATACCCTACCC
GTTGGTCAGATTCACTAATG -> TTGGTCAGATTCACTAATGC
GACTCGTCCACTTATTATGT -> ACTCGTCCACTTATTATGTC
ATCGTGTTTATCGGCGGGAC -> TCGTGTTTATCGGCGGGACT
ATACGGGAATCACACGGGAC -> TACGGGAATCACACGGGACC
GGACTAAAATCTAGGTCGCA -> GACTAAAATCTAGGTCGCAC
ATCATAGATGAGGTCGTTTT -> TCATAGATGAGGTCGTTTTC
CTAGATTACGGTGAAACTAA -> TAGATTACGGTGAAACTAAC
TATGTCTGGACCAGTGTTCC -> ATGTCTGGACCAGTGTTCCG
TCCCGGGTTCTTCCAAATCC -> CCCGGGTTCTTCCAAATCCT
ACTCGTCCACTTATTATGTC -> CTCGTCCACTTATTATGTCT
GTGGTAAAGGCCGGGAAGCG -> TGGTAAAGGCCGGGAAGCGT
CTCTAGGATGCTCTTTTATT -> TCTAGGATGCTCTTTTATTA
CGTATTTGCGTCCGATGCCT -> GTATTTGCGTCCGATGCCTG
CGATGCCTGAGTACCTGACT -> GATGCCTGAGTACCTGACTT
GCCCCGAAACTCCCAGTGGC -> CCCCGAAACTCCCAGTGGCT
ACCGCGTGAGACAGACAGTA -> CCGCGTGAGACAGACAGTAT
TCGACCCCGCAGTTGGTCAG -> CGACCCCGCAGTTGGTCAGA
GGTCATCCGGTGGTAAAGGC -> GTCATCCGGTGGTAAAGGCC
AAAAAGGGACGTGTCGATAT -> AAAAGGGACGTGTCGATATC
CTTATACAGCACTTCTAGAT -> TTATACAGCACTTCTAGATT
CCATACGCGTAAAGGTCCTA -> CATACGCGTAAAGGTCCTAC
ATATTAGCCGTGTCGGGCTG -> TATTAGCCGTGTCGGGCTGG
ACTCCCAGTGGCTGGCGGAC -> CTCCCAGTGGCTGGCGGACT
CTCTGATAAGACATGGGGGT -> TCTGATAAGACATGGGGGTC
TTATGTCTGGACCAGTGTTC -> TATGTCTGGACCAGTGTTCC
GCGTCGATACGGTGCTGACC -> CGTCGATACGGTGCTGACCT
ACTTCTAGATTACGGTGAAA -> CTTCTAGATTACGGTGAAAC
GGAGTACACGATAACAAACT -> GAGTACACGATAACAAACTC
AAAATTTCAGTTTAACGGCC -> AAATTTCAGTTTAACGGCCG
TTTTATTATAGGGTCCATAG -> TTTATTATAGGGTCCATAGT
TTATAGGGTCCATAGTCAGT -> TATAGGGTCCATAGTCAGTA
CGTATGGTTTTGGCCCCGAA -> GTATGGTTTTGGCCCCGAAA
CGCTAATGACCTAGGAAGGT -> GCTAATGACCTAGGAAGGTG
ACCCTAGGCTAGTGAGGGCC -> CCCTAGGCTAGTGAGGGCCT
CGGGAAGCGTCGATACGGTG -> GGGAAGCGTCGATACGGTGC
CACCACGTTTTTAACTGGTA -> ACCACGTTTTTAACTGGTAA
ACGTATGGTTTTGGCCCCGA -> CGTATGGTTTTGGCCCCGAA
TATAATAAAAAGGGACGTGT -> ATAATAAAAAGGGACGTGTC
TAAAGGCCGGGAAGCGTCGA -> AAAGGCCGGGAAGCGTCGAT
TTCTGCCTCGCTCTGATAAG -> TCTGCCTCGCTCTGATAAGA
TTGGTCAGATTCACTAATGC -> TGGTCAGATTCACTAATGCC
ATCTAGGTCGCACGCCAAAA -> TCTAGGTCGCACGCCAAAAA
CTAGGCTAGTGAGGGCCTAC -> TAGGCTAGTGAGGGCCTACC
TGTTGTACATAAATACGGGA -> GTTGTACATAAATACGGGAA
CCACTGACATCGACCCCGCA -> CACTGACATCGACCCCGCAG
GCTGGCGGACTAAAATCTAG -> CTGGCGGACTAAAATCTAGG
ATACGGTGCTGACCTCGGAG -> TACGGTGCTGACCTCGGAGC
TAAAATCTAGGTCGCACGCC -> AAAATCTAGGTCGCACGCCA
ACGATAACAAACTCACTACC -> CGATAACAAACTCACTACCG
GGGCTGGCATGTCAATCGTG -> GGCTGGCATGTCAATCGTGT
GCGCTTATAGTTAAATCCTT -> CGCTTATAGTTAAATCCTTA
AAGCCATACGCGTAAAGGTC -> AGCCATACGCGTAAAGGTCC
TAGGTCGCACGCCAAAAATT -> AGGTCGCACGCCAAAAATTT
ACAGCACTTCTAGATTACGG -> CAGCACTTCTAGATTACGGT
CCTCGCTCTGATAAGACATG -> CTCGCTCTGATAAGACATGG
CAAATGTTGTACATAAATAC -> AAATGTTGTACATAAATACG
ACAGGCGGCGTCTGGTGGGC -> CAGGCGGCGTCTGGTGGGCG
AGTTAAATCCTTATACAGCA -> GTTAAATCCTTATACAGCAC
CGATACGGTGCTGACCTCGG -> GATACGGTGCTGACCTCGGA
CCAGTGTTCCGCGACGTATG -> CAGTGTTCCGCGACGTATGG
GTCTGGACCAGTGTTCCGCG -> TCTGGACCAGTGTTCCGCGA
CCTAGGCTAGTGAGGGCCTA -> CTAGGCTAGTGAGGGCCTAC
GAGGGCCTACCTCTTAAAGC -> AGGGCCTACCTCTTAAAGCT
TTTTGCACGCTAATGACCTA -> TTTGCACGCTAATGACCTAG
GTCGTTTTCCCGGGTTCTTC -> TCGTTTTCCCGGGTTCTTCC
GAGCTGATTCCGGCTCAGGT -> AGCTGATTCCGGCTCAGGTC
GCGCACACAACTTTCTTAAT -> CGCACACAACTTTCTTAATA
CTAACAGTCAGGGCACTAAA -> TAACAGTCAGGGCACTAAAG
GACTGAGGACCTTCTTTGCT -> ACTGAGGACCTTCTTTGCTG
CTCCATGACCCCGAAGCGCT -> TCCATGACCCCGAAGCGCTT
TTAACTGGTAATACAGGCGG -> TAACTGGTAATACAGGCGGC
GCACGGCATGCTTAACTTAG -> CACGGCATGCTTAACTTAGG
TCTTTTATTATAGGGTCCAT -> CTTTTATTATAGGGTCCATA
CCAAGCGACTGAGGACCTTC -> CAAGCGACTGAGGACCTTCT
CAGTGTTCCGCGACGTATGG -> AGTGTTCCGCGACGTATGGT
CACTTATTATGTCTGGACCA -> ACTTATTATGTCTGGACCAG
ACTAATGCCAAATGTTGTAC -> CTAATGCCAAATGTTGTACA
GTTTATCGGCGGGACTTTAA -> TTTATCGGCGGGACTTTAAC
TGCACGCTAATGACCTAGGA -> GCACGCTAATGACCTAGGAA
GGTCCCTCTAGGATGCTCTT -> GTCCCTCTAGGATGCTCTTT
ACCCCGCAGTTGGTCAGATT -> CCCCGCAGTTGGTCAGATTC
GTAGGAGAGTTGCGCCAGGT -> TAGGAGAGTTGCGCCAGGTC
GACCCCGAAGCGCTTATAGT -> ACCCCGAAGCGCTTATAGTT
TCAGGTCCCTCTAGGATGCT -> CAGGTCCCTCTAGGATGCTC
AAAGCTACGCCAAGCGACTG -> AAGCTACGCCAAGCGACTGA
CTGCCTCGCTCTGATAAGAC -> TGCCTCGCTCTGATAAGACA
CTAAAGACCCTGGACCTCAA -> TAAAGACCCTGGACCTCAAG
GTTAAATCCTTATACAGCAC -> TTAAATCCTTATACAGCACT
CTGACCTCGGAGCTCCATAA -> TGACCTCGGAGCTCCATAAC
CCTTCTTTGCTGCGTTGCGC -> CTTCTTTGCTGCGTTGCGCA
AGGGTCCATAGTCAGTATAA -> GGGTCCATAGTCAGTATAAT
AGGCGGCGTCTGGTGGGCGA -> GGCGGCGTCTGGTGGGCGAG
GCCATACGCGTAAAGGTCCT -> CCATACGCGTAAAGGTCCTA
GAGTGACTCGTCCACTTATT -> AGTGACTCGTCCACTTATTA
GGGTCCATAGTCAGTATAAT -> GGTCCATAGTCAGTATAATC
GAGGTCGTTTTCCCGGGTTC -> AGGTCGTTTTCCCGGGTTCT
CTAAAATCTAGGTCGCACGC -> TAAAATCTAGGTCGCACGCC
ACCTCAAGGAGTACACGATA -> CCTCAAGGAGTACACGATAA
AGTCTGAGCTGATTCCGGCT -> GTCTGAGCTGATTCCGGCTC
GGAGGCAGTGATATTAGCCG -> GAGGCAGTGATATTAGCCGT
TCTTAGCACGGCATGCTTAA -> CTTAGCACGGCATGCTTAAC
ACAACTTTCTTAATAATCAT -> CAACTTTCTTAATAATCATA
GATAAGACATGGGGGTCATC -> ATAAGACATGGGGGTCATCC
CTAGGATGCTCTTTTATTAT -> TAGGATGCTCTTTTATTATA
GGGCACTAAAGACCCTGGAC -> GGCACTAAAGACCCTGGACC
CCCTACCCTAGGCTAGTGAG -> CCTACCCTAGGCTAGTGAGG
CTATTAGTAGTATCCGCACT -> TATTAGTAGTATCCGCACTC
CGTTTTTAACTGGTAATACA -> GTTTTTAACTGGTAATACAG
ACATAAATACGGGAATCACA -> CATAAATACGGGAATCACAC
AACTTTCTTAATAATCATAG -> ACTTTCTTAATAATCATAGA
TCTTAAAGCTACGCCAAGCG -> CTTAAAGCTACGCCAAGCGA
CTCAGAGACTGCAAAGCCAT -> TCAGAGACTGCAAAGCCATA
GTCAATCGTGTTTATCGGCG -> TCAATCGTGTTTATCGGCGG
CCCGAAGCGCTTATAGTTAA -> CCGAAGCGCTTATAGTTAAA
GGCGAGGGAGGCAGTGATAT -> GCGAGGGAGGCAGTGATATT
TAGTATCCGCACTCCATGAC -> AGTATCCGCACTCCATGACC
TTCCGGCTCAGGTCCCTCTA -> TCCGGCTCAGGTCCCTCTAG
AACTAACAGTCAGGGCACTA -> ACTAACAGTCAGGGCACTAA
GGGGCCCGTTTTGCACGCTA -> GGGCCCGTTTTGCACGCTAA
GTTCTTCCAAATCCTATTAG -> TTCTTCCAAATCCTATTAGT
ATGACCCCGAAGCGCTTATA -> TGACCCCGAAGCGCTTATAG
TTATAATAAAAAGGGACGTG -> TATAATAAAAAGGGACGTGT
CATGCTTAACTTAGGGGCCC -> ATGCTTAACTTAGGGGCCCG
ACCCCGAAGCGCTTATAGTT -> CCCCGAAGCGCTTATAGTTA
CGGTGCTGACCTCGGAGCTC -> GGTGCTGACCTCGGAGCTCC
AAGGTGACTCAGAGACTGCA -> AGGTGACTCAGAGACTGCAA
TCAGTTTAACGGCCGTTTCG -> CAGTTTAACGGCCGTTTCGT
GGAGAGTTGCGCCAGGTCAT -> GAGAGTTGCGCCAGGTCATA
GTCCGATGCCTGAGTACCTG -> TCCGATGCCTGAGTACCTGA
CTCGTCCACTTATTATGTCT -> TCGTCCACTTATTATGTCTG
TTAGCACGGCATGCTTAACT -> TAGCACGGCATGCTTAACTT
AGTAGTATCCGCACTCCATG -> GTAGTATCCGCACTCCATGA
CTGAGGACCTTCTTTGCTGC -> TGAGGACCTTCTTTGCTGCG
CTCAGAGTGACTCGTCCACT -> TCAGAGTGACTCGTCCACTT
GTATTTGCGTCCGATGCCTG -> TATTTGCGTCCGATGCCTGA
CGGGCTGGCATGTCAATCGT -> GGGCTGGCATGTCAATCGTG
ATTTCAGTTTAACGGCCGTT -> TTTCAGTTTAACGGCCGTTT
CTGACATCGACCCCGCAGTT -> TGACATCGACCCCGCAGTTG
TAACAAACTCACTACCGGGT -> AACAAACTCACTACCGGGTG
GCACACAACTTTCTTAATAA -> CACACAACTTTCTTAATAAT
TCATACCCTACCCTAGGCTA -> CATACCCTACCCTAGGCTAG
GCCAAATGTTGTACATAAAT -> CCAAATGTTGTACATAAATA
GAGGCAGTGATATTAGCCGT -> AGGCAGTGATATTAGCCGTG
TAACTTAGGGGCCCGTTTTG -> AACTTAGGGGCCCGTTTTGC
ACCTCGGAGCTCCATAACGT -> CCTCGGAGCTCCATAACGTA
CGGCATGCTTAACTTAGGGG -> GGCATGCTTAACTTAGGGGC
TCCTATTCTGTAGATCTTAG -> CCTATTCTGTAGATCTTAGC
GTTGTACATAAATACGGGAA -> TTGTACATAAATACGGGAAT
CAGTGATATTAGCCGTGTCG -> AGTGATATTAGCCGTGTCGG
ACCTTCTTTGCTGCGTTGCG -> CCTTCTTTGCTGCGTTGCGC
GTGTTCCGCGACGTATGGTT -> TGTTCCGCGACGTATGGTTT
GGTAAAGGCCGGGAAGCGTC -> GTAAAGGCCGGGAAGCGTCG
CAGTTGGTCAGATTCACTAA -> AGTTGGTCAGATTCACTAAT
CTTATAGTTAAATCCTTATA -> TTATAGTTAAATCCTTATAC
AGGGGCCCGTTTTGCACGCT -> GGGGCCCGTTTTGCACGCTA
GGCCTACCTCTTAAAGCTAC -> GCCTACCTCTTAAAGCTACG
TAGTTAAATCCTTATACAGC -> AGTTAAATCCTTATACAGCA
TTATCGGCGGGACTTTAACC -> TATCGGCGGGACTTTAACCA
GACAGTATGTTCTGCCTCGC -> ACAGTATGTTCTGCCTCGCT
