30 100
AATCTACAAAGACCTGTGCAGTAGTAGAAA|GCATGAAGGACAATCCAGGACAATCCCGAG
CCGACATGGGACAAGTAAACCACGCACAAG|TGTACCCTTCGGCTGTAGCGAGGAGGTAGG
GCCCTAAGTTTTAACTGCACAAGTACCAGG|TGAAGGACAATCCGTATTCCACAATATTAG
AGCTTAAGATAGCGCTCCGAGGCACGTACG|GAAGGACAATCCAATCCCAGGCGCATGAAG
CAGTTCCGACTTTTTGCTGCCGGCACCCGT|TCATAACTCCCGCCTGATAAGCTGTATGCT
GATGTGCGCGACCCACAAGTACCAGGCGCA|ACAAGTACCAGGCGCATGAAGGACAATCCT
ACTAGCGCGCGCTCCCAAATGTTCATGTGG|TTTGTTTGATGAGGATAGAAGGACACTGGG
ATCCAGGACAATCCCGAGGGCACAAGTACC|TGCTTGTCGCTACGCAGCTTAAGATAGCGC
GAAGGACAATCCGACACAAGTACCAGGCGC|CACAAGTACCAGGCGCATGAAGGACAATCC
CCGCCTGATAAGCTGTATGCTGTGAGTAAA|CTACAAAGACCTGTGCAGTAGTAGAAATCT
CAAGTACCAGGCGCATGAAGGACAATCCTC|ATGAAGGACAATCCTACACAAGTACCAGGC
GCATGGGTGGAGTAGTGTGGTGCCCTTATT|TTCATGTGGCCACAGACACCAACGCGTAGA
AAGGACAATCCGTATTCCACAATATTAGAA|CGTACGAATGCCTGGCACTTGTAAAGCAGT
GACAACAGCCTATGCGTCGTTCCCAACAGT|AAGCAGTAACTTATGATGCCTGATTATGAG
AATCCTCGCTTAATCCCACCGAGGCAGATG|ACCAGGCGCATGAAGGACAATCCCCAAGTG
CTGGCACTTGTAAAGCAGTCCTTACGTACT|TCCCGTGCTTTCCGGATTATACCTGGGTGG
CCAGGCGCATGAAGGACAATCCCCTTGCAG|TCACCAAGTCTCCGGAATTAGGTCGTTGAA
GTACCAGGCGCATGAAGGACAATCCGTATT|AGCGCTCCGAGGCACGTACGAATGCCTGGC
CCCTCCGGTGCTGGCCAAGCAGTAACTTAT|TTGAGTCGTACACCAGTTCCGACTTTTTGC
TATTAGAAGCACCGAAGGGCGATATAAGTC|AAAGCAGTCCTTACGTACTTCAGCTGGCGG
AGTAAAGATCACTTAGCACAAGTACCACAC|AAATCTAGTTTTGACGCACGGCGCCCTAAG
TTAACTGCACAAGTACCAGGCGCATCACAA|TCCGTATTCCACAATATTAGAAGCACCGAA
TCTTGTGCCACAAGTACCAGGCGCATGAAG|AGGCAACCGACATGGGACAAGTAAACCACG
AGCTTGTGGATTCGAGCAACGCCGTGATTT|TGAAGGACAATCCGCCCATCTACGCCGCCG
ATCACAAGTACCAGGCGCATGAAGGACAAT|CACCGAAGGGCGATATAAGTCACAAGTACC
TGCGTCGTTCCCAACAGTTCTTGTGCCACA|ATGATGCCTGATTATGAGAGGCAACCGACA
ATGCTTGTCGCTACGCAGCTTAAGATAGCG|CAAGTACCAGGCGCATGAAGGACAATCCAA
CGCATGAAGGACAATCCGATAAGGCAAGTG|CATGCGACGCACCATGCACAAGCTTGTGGA
TATTAAGTCTTACGCCCTTCCACTGCAGGG|TAGAGTCGGCTCCAAGGTATGCAGCGCAAC
GTCGCTACGCAGCTTAAGATAGCGCTCCGA|CCAGGCGCATGAAGGACAATCCAATCCCAG
CATGAAGGACAATCCGACACAAGTACCAGG|AGTCACAAGTACCAGGCGCATGAAGGACAA
AATCCCACCGAGGCAGATGCTAGTGAGCGG|GAAGGACAATCCCCAAGTGTCTCCCCCCCT
ACCCACAAGTACCAGGCGCATGAAGGACAA|GGCGCATGAAGGACAATCCTACACAAGTAC
CTGTACCCTTCGGCTGTAGCGAGGAGGTAG|AGATCACTTAGCACAAGTACCACACAAGTA
GATTCGAGCAACGCCGTGATTTGGAGTCAT|AATCCGCCCATCTACGCCGCCGGGAGAACT
GGTGGAGTAGTGTGGTGCCCTTATTAAGTC|GTGGCCACAGACACCAACGCGTAGAGTCGG
GAGTAGTGTGGTGCCCTTATTAAGTCTTAC|CCACAGACACCAACGCGTAGAGTCGGCTCC
TGGGTGGAGTAGTGTGGTGCCCTTATTAAG|ATGTGGCCACAGACACCAACGCGTAGAGTC
GGGCACAAGTACCAGGCGCATGAAGGACAA|CTTAAGATAGCGCTCCGAGGCACGTACGAA
CCAGGACAATCCCGAGGGCACAAGTACCAG|CTTGTCGCTACGCAGCTTAAGATAGCGCTC
CCCTTCGGCTGTAGCGAGGAGGTAGGAAAC|ACTTAGCACAAGTACCACACAAGTACCAGG
ACGCCCTTCCACTGCAGGGCACAAGTACCA|CCAAGGTATGCAGCGCAACAAAACCCGTCA
TGTGCAGTAGTAGAAATCTAGTTTTGACGC|CCAGGACAATCCCGAGGGCACAAGTACCAG
AGCAGTAACTTATGATGCCTGATTATGAGA|TCCGACTTTTTGCTGCCGGCACCCGTGAAT
CGTATTCCACAATATTAGAAGCACCGAAGG|CCTGGCACTTGTAAAGCAGTCCTTACGTAC
ATTATGAGAGGCAACCGACATGGGACAAGT|CCCGTGAATGAAACTGTACCCTTCGGCTGT
CGCATGAAGGACAATCCTACACAAGTACCA|TAAACCACGCACAAGTACCAGGCGCATGAA
GCTTAATCCCACCGAGGCAGATGCTAGTGA|GCATGAAGGACAATCCCCAAGTGTCTCCCC
GCGCATGAAGGACAATCCGACACAAGTACC|ATAAGTCACAAGTACCAGGCGCATGAAGGA
AAGTACCAGGCGCATCACAAGTACCAGGCG|ACAATATTAGAAGCACCGAAGGGCGATATA
GCATGAAGGACAATCCTTACAGGCTATGCT|CAAGTACCAGGCGCATGAAGGACCACAAGT
GGCGCATGAAGGACAATCCAGGACAATCCC|AATCCTTACAGGCTATGCTTGTCGCTACGC
ACAATCCTCGCTTAATCCCACCGAGGCAGA|GTACCAGGCGCATGAAGGACAATCCCCAAG
GATCACTTAGCACAAGTACCACACAAGTAC|AGTTTTGACGCACGGCGCCCTAAGTTTTAA
TGGAAAACCATCACGAGCTTGGGGCTACCA|AGCGGAAGCGACTTACAGACAACAGCCTAT
GAGGCACGTACGAATGCCTGGCACTTGTAA|AGGCGCATGAAGGACAATCCCGTGCTTTCC
CCTGTGCAGTAGTAGAAATCTAGTTTTGAC|ATCCAGGACAATCCCGAGGGCACAAGTACC
GGCGCATGAAGGACAATCCGATAAGGCAAG|TGCATGCGACGCACCATGCACAAGCTTGTG
CAAGTACCAGGCGCATGAAGGACAATCCGT|GATAGCGCTCCGAGGCACGTACGAATGCCT
AAGTAAACCACGCACAAGTACCAGGCGCAT|CTGTAGCGAGGAGGTAGGAAACGTGCATGC
CAAGTACCAGGCGCATGAAGGACAATCCTT|CCACAAGTACCACAAGTACCAGGCGCATGA
GTCCCTCACCACTGCGTCAAGATGTGCGCG|TTCCCAACAGTTCTTGTGCCACAAGTACCA
ATATAATCCGAACTAGCGCGCGCTCCCAAA|TGCGACCCAGCTTTGTTTGATGAGGATAGA
TCCCCAAGTGTCTCCCCCCCTCCGGTGCTG|CAAGTGTTCAGTAATCATTGAGTCGTACAC
TACCACAAGTACCAGGCGCATGAAGGACCA|TGCCCTTATTAAGTCTTACGCCCTTCCACT
GTCTTACGCCCTTCCACTGCAGGGCACAAG|CGGCTCCAAGGTATGCAGCGCAACAAAACC
GGCAACCGACATGGGACAAGTAAACCACGC|GAAACTGTACCCTTCGGCTGTAGCGAGGAG
GCAACCGACATGGGACAAGTAAACCACGCA|AAACTGTACCCTTCGGCTGTAGCGAGGAGG
CGAATATAATCCGAACTAGCGCGCGCTCCC|ATATGCGACCCAGCTTTGTTTGATGAGGAT
AGGACAATCCTTACAGGCTATGCTTGTCGC|CCAGGCGCATGAAGGACCACAAGTACCAGG
CAGGCGCATGAAGGACAATCCCGTGCTTTC|TCCCCTTGCAGACGAATATAATCCGAACTA
GGGACAAGTAAACCACGCACAAGTACCAGG|TTCGGCTGTAGCGAGGAGGTAGGAAACGTG
TGTGGTGCCCTTATTAAGTCTTACGCCCTT|ACACCAACGCGTAGAGTCGGCTCCAAGGTA
AAGGACAATCCCCTTGCAGACGAATATAAT|CCGGAATTAGGTCGTTGAAAATATGCGACC
GCATGAAGGACAATCCCCTTGCAGACGAAT|AGTCTCCGGAATTAGGTCGTTGAAAATATG
ACCGACATGGGACAAGTAAACCACGCACAA|CTGTACCCTTCGGCTGTAGCGAGGAGGTAG
AATCCGACACAAGTACCAGGCGCATGAAGG|ACCAGGCGCATGAAGGACAATCCTTACAGG
CCCGTGCTTTCCGGATTATACCTGGGTGGC|AATCCGAACTAGCGCGCGCTCCCAAATGTT
TAAGATAGCGCTCCGAGGCACGTACGAATG|GACAATCCAATCCCAGGCGCATGAAGGACA
GACAATCCCCAAGTGTCTCCCCCCCTCCGG|TAAGGCAAGTGTTCAGTAATCATTGAGTCG
GTTCAGTAATCATTGAGTCGTACACCAGTT|ATTCGAGCAACGCCGTGATTTGGAGTCATA
CGCCGGGAGAACTTGAATCTACAAAGACCT|ACACAAGTACCAGGCGCATGAAGGACAATC
CACGCACAAGTACCAGGCGCATGAAGGACA|AGGAGGTAGGAAACGTGCATGCGACGCACC
GTACCAGGCGCATGAAGGACAATCCTTACA|CAAGTACCACAAGTACCAGGCGCATGAAGG
GAATGCCTGGCACTTGTAAAGCAGTCCTTA|GGACAATCCCGTGCTTTCCGGATTATACCT
CGGAAGCGACTTACAGACAACAGCCTATGC|CCTCCGGTGCTGGCCAAGCAGTAACTTATG
ATCCGATAAGGCAAGTGTTCAGTAATCATT|ATGCACAAGCTTGTGGATTCGAGCAACGCC
ATGAAGGACAATCCCCTTGCAGACGAATAT|TCTCCGGAATTAGGTCGTTGAAAATATGCG
GGAAACGTGCATGCGACGCACCATGCACAA|ACCAGGCGCATGAAGGACAATCCGGCGCAT
CTACAAAGACCTGTGCAGTAGTAGAAATCT|TGAAGGACAATCCAGGACAATCCCGAGGGC
GGTGCTGGCCAAGCAGTAACTTATGATGCC|CGTACACCAGTTCCGACTTTTTGCTGCCGG
CGCTCCGAGGCACGTACGAATGCCTGGCAC|AATCCCAGGCGCATGAAGGACAATCCCGTG
GCGCGCTCCCAAATGTTCATGTGGCCACAG|TGATGAGGATAGAAGGACACTGGGCGACCC
GAAACGTGCATGCGACGCACCATGCACAAG|CCAGGCGCATGAAGGACAATCCGGCGCATG
GACAATCCGCCCATCTACGCCGCCGGGAGA|GGCGCATGAAGGACAATCCGACACAAGTAC
CGCCCTTCCACTGCAGGGCACAAGTACCAG|CAAGGTATGCAGCGCAACAAAACCCGTCAC
GAAGGACAATCCGCCCATCTACGCCGCCGG|ACCAGGCGCATGAAGGACAATCCGACACAA
TGCAGGGCACAAGTACCAGGCGCATGAAGG|GCGCAACAAAACCCGTCACCAAGTCTCCGG
CGCAGCTTAAGATAGCGCTCCGAGGCACGT|CATGAAGGACAATCCAATCCCAGGCGCATG
CTTGGGGCTACCAAATTAAGTCCCTCACCA|GACAACAGCCTATGCGTCGTTCCCAACAGT
GGCGCATGAAGGACAATCCAATCCCAGGCG|AAGTACCAGGCGCATGAAGGACAATCCCCT
CCGGATTATACCTGGGTGGCATGGGTGGAG|AGCGCGCGCTCCCAAATGTTCATGTGGCCA
GCACAAGTACCAGGCGCATGAAGGACAATC|TAAGATAGCGCTCCGAGGCACGTACGAATG
GGACAATCCCGAGGGCACAAGTACCAGGCG|GTCGCTACGCAGCTTAAGATAGCGCTCCGA
GAGGGCACAAGTACCAGGCGCATGAAGGAC|AGCTTAAGATAGCGCTCCGAGGCACGTACG
TGTAGCGAGGAGGTAGGAAACGTGCATGCG|AAGTACCACACAAGTACCAGGCGCATGAAG
GGACAATCCCGTGCTTTCCGGATTATACCT|CGAATATAATCCGAACTAGCGCGCGCTCCC
CGTACTTCAGCTGGCGGGCCACAAGTACCA|GGGTGGCATGGGTGGAGTAGTGTGGTGCCC
GCCGGGAGAACTTGAATCTACAAAGACCTG|CACAAGTACCAGGCGCATGAAGGACAATCC
GCGTCGTTCCCAACAGTTCTTGTGCCACAA|TGATGCCTGATTATGAGAGGCAACCGACAT
CAAGTACCAGGCGCATGAAGGACAATCCCC|GCGCATGAAGGACAATCCGATAAGGCAAGT
CTGCAGGGCACAAGTACCAGGCGCATGAAG|AGCGCAACAAAACCCGTCACCAAGTCTCCG
TTTGACGCACGGCGCCCTAAGTTTTAACTG|AGTACCAGGCGCATGAAGGACAATCCGTAT
GAAGGACAATCCTTACAGGCTATGCTTGTC|TACCAGGCGCATGAAGGACCACAAGTACCA
CCCTAAGTTTTAACTGCACAAGTACCAGGC|GAAGGACAATCCGTATTCCACAATATTAGA
ACCAGGCGCATGAAGGACAATCCAGGACAA|GGACAATCCTTACAGGCTATGCTTGTCGCT
GTACCACAAGTACCAGGCGCATGAAGGACC|GTGCCCTTATTAAGTCTTACGCCCTTCCAC
CCACAAGTACCAGGCGCATGAAGGACAATC|CGCATGAAGGACAATCCTACACAAGTACCA
GCTTGTGGATTCGAGCAACGCCGTGATTTG|GAAGGACAATCCGCCCATCTACGCCGCCGG
TACCAGGCGCATGAAGGACAATCCTCGCTT|AGGACAATCCTACACAAGTACCAGGCGCAT
CAGCTGGCGGGCCACAAGTACCACAAGTAC|ATGGGTGGAGTAGTGTGGTGCCCTTATTAA
TACCAGGCGCATGAAGGACAATCCAATCCC|GGCACAAGTACCAGGCGCATGAAGGACAAT
TTTGCTGCCGGCACCCGTGAATGAAACTGT|CCTGATAAGCTGTATGCTGTGAGTAAAGAT
GCTTTCCGGATTATACCTGGGTGGCATGGG|GAACTAGCGCGCGCTCCCAAATGTTCATGT
ACGCAGCTTAAGATAGCGCTCCGAGGCACG|GCATGAAGGACAATCCAATCCCAGGCGCAT
CTTTTTGCTGCCGGCACCCGTGAATGAAAC|CCGCCTGATAAGCTGTATGCTGTGAGTAAA
CGAGGCACGTACGAATGCCTGGCACTTGTA|CAGGCGCATGAAGGACAATCCCGTGCTTTC
TTAAGTCCCTCACCACTGCGTCAAGATGTG|GTCGTTCCCAACAGTTCTTGTGCCACAAGT
GTGCTTTCCGGATTATACCTGGGTGGCATG|CCGAACTAGCGCGCGCTCCCAAATGTTCAT
ATCCAATCCCAGGCGCATGAAGGACAATCC|GAAGGACAATCCCCTTGCAGACGAATATAA
GCGACCCACAAGTACCAGGCGCATGAAGGA|CCAGGCGCATGAAGGACAATCCTACACAAG
CGTCAAGATGTGCGCGACCCACAAGTACCA|TGTGCCACAAGTACCAGGCGCATGAAGGAC
ACCAAATTAAGTCCCTCACCACTGCGTCAA|CTATGCGTCGTTCCCAACAGTTCTTGTGCC
CAGCTTAAGATAGCGCTCCGAGGCACGTAC|TGAAGGACAATCCAATCCCAGGCGCATGAA
AACAGCCTATGCGTCGTTCCCAACAGTTCT|CAGTAACTTATGATGCCTGATTATGAGAGG
GATGTTGGAAAACCATCACGAGCTTGGGGC|TAGTGAGCGGAAGCGACTTACAGACAACAG
ATCCCACCGAGGCAGATGCTAGTGAGCGGA|AAGGACAATCCCCAAGTGTCTCCCCCCCTC
CTGGCGGGCCACAAGTACCACAAGTACCAG|GGTGGAGTAGTGTGGTGCCCTTATTAAGTC
GACAATCCGATAAGGCAAGTGTTCAGTAAT|CACCATGCACAAGCTTGTGGATTCGAGCAA
CACAAGTACCAGGCGCATGAAGGACAATCC|GACATGGGACAAGTAAACCACGCACAAGTA
CATCACAAGTACCAGGCGCATGAAGGACAA|GCACCGAAGGGCGATATAAGTCACAAGTAC
GTGGAGTAGTGTGGTGCCCTTATTAAGTCT|TGGCCACAGACACCAACGCGTAGAGTCGGC
GCACAAGCTTGTGGATTCGAGCAACGCCGT|GCGCATGAAGGACAATCCGCCCATCTACGC
GGACAATCCTACACAAGTACCAGGCGCATG|GCACAAGTACCAGGCGCATGAAGGACAATC
CATGAAGGACAATCCTCGCTTAATCCCACC|CTACACAAGTACCAGGCGCATGAAGGACAA
GAAGGACAATCCCGTGCTTTCCGGATTATA|AGACGAATATAATCCGAACTAGCGCGCGCT
AAGGACAATCCTTACAGGCTATGCTTGTCG|ACCAGGCGCATGAAGGACCACAAGTACCAG
CATGAAGGACAATCCCCTTGCAGACGAATA|GTCTCCGGAATTAGGTCGTTGAAAATATGC
CAGGCGCATGAAGGACAATCCTACACAAGT|CAAGTAAACCACGCACAAGTACCAGGCGCA
AGTCGTACACCAGTTCCGACTTTTTGCTGC|TGATTTGGAGTCATAACTCCCGCCTGATAA
CTGGGTGGCATGGGTGGAGTAGTGTGGTGC|CCAAATGTTCATGTGGCCACAGACACCAAC
CGACTTACAGACAACAGCCTATGCGTCGTT|GTGCTGGCCAAGCAGTAACTTATGATGCCT
AAGGACAATCCGCCCATCTACGCCGCCGGG|CCAGGCGCATGAAGGACAATCCGACACAAG
CGACCCACAAGTACCAGGCGCATGAAGGAC|CAGGCGCATGAAGGACAATCCTACACAAGT
GACAATCCCGAGGGCACAAGTACCAGGCGC|TCGCTACGCAGCTTAAGATAGCGCTCCGAG
CCAGGCGCATGAAGGACAATCCAGGACAAT|GACAATCCTTACAGGCTATGCTTGTCGCTA
TACCAGGCGCATGAAGGACAATCCGTATTC|GCGCTCCGAGGCACGTACGAATGCCTGGCA
ATATTAGAAGCACCGAAGGGCGATATAAGT|TAAAGCAGTCCTTACGTACTTCAGCTGGCG
AATCCAGGACAATCCCGAGGGCACAAGTAC|ATGCTTGTCGCTACGCAGCTTAAGATAGCG
TGATGCCTGATTATGAGAGGCAACCGACAT|CTGCCGGCACCCGTGAATGAAACTGTACCC
ATCCCCAAGTGTCTCCCCCCCTCCGGTGCT|GCAAGTGTTCAGTAATCATTGAGTCGTACA
CGCCCTAAGTTTTAACTGCACAAGTACCAG|ATGAAGGACAATCCGTATTCCACAATATTA
TAAGTCACAAGTACCAGGCGCATGAAGGAC|TGGCGGGCCACAAGTACCACAAGTACCAGG
AACTCCCGCCTGATAAGCTGTATGCTGTGA|TGAATCTACAAAGACCTGTGCAGTAGTAGA
TGAAGGACAATCCGTATTCCACAATATTAG|CACGTACGAATGCCTGGCACTTGTAAAGCA
CCGAACTAGCGCGCGCTCCCAAATGTTCAT|CAGCTTTGTTTGATGAGGATAGAAGGACAC
TCCTACACAAGTACCAGGCGCATGAAGGAC|GTACCAGGCGCATGAAGGACAATCCGATAA
TCATAACTCCCGCCTGATAAGCTGTATGCT|AACTTGAATCTACAAAGACCTGTGCAGTAG
CTTGTGCCACAAGTACCAGGCGCATGAAGG|GGCAACCGACATGGGACAAGTAAACCACGC
TCACGAGCTTGGGGCTACCAAATTAAGTCC|ACTTACAGACAACAGCCTATGCGTCGTTCC
ACCATCACGAGCTTGGGGCTACCAAATTAA|AGCGACTTACAGACAACAGCCTATGCGTCG
AGGCAACCGACATGGGACAAGTAAACCACG|TGAAACTGTACCCTTCGGCTGTAGCGAGGA
CACTGCAGGGCACAAGTACCAGGCGCATGA|GCAGCGCAACAAAACCCGTCACCAAGTCTC
AACTTGAATCTACAAAGACCTGTGCAGTAG|CCAGGCGCATGAAGGACAATCCAGGACAAT
CTTAATCCCACCGAGGCAGATGCTAGTGAG|CATGAAGGACAATCCCCAAGTGTCTCCCCC
CAGGCGCATGAAGGACAATCCTTACAGGCT|TACCACAAGTACCAGGCGCATGAAGGACCA
TGGGTGGCATGGGTGGAGTAGTGTGGTGCC|CAAATGTTCATGTGGCCACAGACACCAACG
CCGATAAGGCAAGTGTTCAGTAATCATTGA|GCACAAGCTTGTGGATTCGAGCAACGCCGT
GATTATACCTGGGTGGCATGGGTGGAGTAG|GCGCGCTCCCAAATGTTCATGTGGCCACAG
GAATGAAACTGTACCCTTCGGCTGTAGCGA|GTGAGTAAAGATCACTTAGCACAAGTACCA
GCTGGCGGGCCACAAGTACCACAAGTACCA|GGGTGGAGTAGTGTGGTGCCCTTATTAAGT
TGGCACTTGTAAAGCAGTCCTTACGTACTT|CCCGTGCTTTCCGGATTATACCTGGGTGGC
GTACCAGGCGCATGAAGGACAATCCCCTTG|CCGTCACCAAGTCTCCGGAATTAGGTCGTT
CAACCGACATGGGACAAGTAAACCACGCAC|AACTGTACCCTTCGGCTGTAGCGAGGAGGT
TACTTCAGCTGGCGGGCCACAAGTACCACA|GTGGCATGGGTGGAGTAGTGTGGTGCCCTT
AGTCACAAGTACCAGGCGCATGAAGGACAA|GCGGGCCACAAGTACCACAAGTACCAGGCG
ACTTGAATCTACAAAGACCTGTGCAGTAGT|CAGGCGCATGAAGGACAATCCAGGACAATC
GGACAATCCGCCCATCTACGCCGCCGGGAG|AGGCGCATGAAGGACAATCCGACACAAGTA
AGTACCAGGCGCATCACAAGTACCAGGCGC|CAATATTAGAAGCACCGAAGGGCGATATAA
CCACTGCAGGGCACAAGTACCAGGCGCATG|TGCAGCGCAACAAAACCCGTCACCAAGTCT
GGCTATGCTTGTCGCTACGCAGCTTAAGAT|ACCACAAGTACCAGGCGCATGAAGGACAAT
TGAAGGACAATCCCCTTGCAGACGAATATA|CTCCGGAATTAGGTCGTTGAAAATATGCGA
TACGTACTTCAGCTGGCGGGCCACAAGTAC|CTGGGTGGCATGGGTGGAGTAGTGTGGTGC
ACAAGTACCAGGCGCATGAAGGACAATCCT|GCCACAAGTACCACAAGTACCAGGCGCATG
CAGGCGCATGAAGGACAATCCGATAAGGCA|CGTGCATGCGACGCACCATGCACAAGCTTG
CAAGTACCAGGCGCATGAAGGACCACAAGT|TTATTAAGTCTTACGCCCTTCCACTGCAGG
CGCGCTCCCAAATGTTCATGTGGCCACAGA|GATGAGGATAGAAGGACACTGGGCGACCCG
TAGCGAGGAGGTAGGAAACGTGCATGCGAC|GTACCACACAAGTACCAGGCGCATGAAGGA
TTCTTGTGCCACAAGTACCAGGCGCATGAA|GAGGCAACCGACATGGGACAAGTAAACCAC
GCGACGCACCATGCACAAGCTTGTGGATTC|AAGGACAATCCGGCGCATGAAGGACAATCC
GTACCAGGCGCATGAAGGACAATCCAGGAC|AAGGACAATCCTTACAGGCTATGCTTGTCG
AAGGACAATCCCCAAGTGTCTCCCCCCCTC|CGATAAGGCAAGTGTTCAGTAATCATTGAG
CGCACGGCGCCCTAAGTTTTAACTGCACAA|CAGGCGCATGAAGGACAATCCGTATTCCAC
CCCGAGGGCACAAGTACCAGGCGCATGAAG|CGCAGCTTAAGATAGCGCTCCGAGGCACGT
CCACCGAGGCAGATGCTAGTGAGCGGAAGC|GACAATCCCCAAGTGTCTCCCCCCCTCCGG
GTCAAGATGTGCGCGACCCACAAGTACCAG|GTGCCACAAGTACCAGGCGCATGAAGGACA
CATTGAGTCGTACACCAGTTCCGACTTTTT|CGCCGTGATTTGGAGTCATAACTCCCGCCT
GTGAATGAAACTGTACCCTTCGGCTGTAGC|CTGTGAGTAAAGATCACTTAGCACAAGTAC
CAAGTACCAGGCGCATGAAGGACAATCCCC|AACCCGTCACCAAGTCTCCGGAATTAGGTC
ATCCGTATTCCACAATATTAGAAGCACCGA|ATGCCTGGCACTTGTAAAGCAGTCCTTACG
ATGAAGGACAATCCGTATTCCACAATATTA|GCACGTACGAATGCCTGGCACTTGTAAAGC
ACTCCCGCCTGATAAGCTGTATGCTGTGAG|GAATCTACAAAGACCTGTGCAGTAGTAGAA
ACAGGCTATGCTTGTCGCTACGCAGCTTAA|AGGACCACAAGTACCAGGCGCATGAAGGAC
TGTGAGTAAAGATCACTTAGCACAAGTACC|GTAGAAATCTAGTTTTGACGCACGGCGCCC
ACAAGTACCACAAGTACCAGGCGCATGAAG|TGTGGTGCCCTTATTAAGTCTTACGCCCTT
GGCGCATGAAGGACAATCCCCAAGTGTCTC|GGACAATCCGATAAGGCAAGTGTTCAGTAA
GAGTCGTACACCAGTTCCGACTTTTTGCTG|GTGATTTGGAGTCATAACTCCCGCCTGATA
GGCGCATGAAGGACAATCCGCCCATCTACG|CACAAGTACCAGGCGCATGAAGGACAATCC
GTACCAGGCGCATGAAGGACAATCCGATAA|GAAACGTGCATGCGACGCACCATGCACAAG
AGATGTGCGCGACCCACAAGTACCAGGCGC|CACAAGTACCAGGCGCATGAAGGACAATCC
GTGGATTCGAGCAACGCCGTGATTTGGAGT|GACAATCCGCCCATCTACGCCGCCGGGAGA
CGACGCACCATGCACAAGCTTGTGGATTCG|AGGACAATCCGGCGCATGAAGGACAATCCG
GGGGCTACCAAATTAAGTCCCTCACCACTG|AACAGCCTATGCGTCGTTCCCAACAGTTCT
ACTTAGCACAAGTACCACACAAGTACCAGG|TTGACGCACGGCGCCCTAAGTTTTAACTGC
ACCAGGCGCATGAAGGACAATCCGACACAA|GCGATATAAGTCACAAGTACCAGGCGCATG
CGTCGTTCCCAACAGTTCTTGTGCCACAAG|GATGCCTGATTATGAGAGGCAACCGACATG
CACAAGTACCAGGCGCATGAAGGACAATCC|AGGCGCATGAAGGACAATCCGATAAGGCAA
CCAGGCGCATGAAGGACAATCCCCAAGTGT|GAAGGACAATCCGATAAGGCAAGTGTTCAG
ACTTATGATGCCTGATTATGAGAGGCAACC|TTTTGCTGCCGGCACCCGTGAATGAAACTG
TGCAGTAGTAGAAATCTAGTTTTGACGCAC|AGGACAATCCCGAGGGCACAAGTACCAGGC
CACAAGTACCAGGCGCATGAAGGACAATCC|AAAACCCGTCACCAAGTCTCCGGAATTAGG
TGAGTCGTACACCAGTTCCGACTTTTTGCT|CGTGATTTGGAGTCATAACTCCCGCCTGAT
GCCCTTATTAAGTCTTACGCCCTTCCACTG|ACGCGTAGAGTCGGCTCCAAGGTATGCAGC
GGACAATCCTTACAGGCTATGCTTGTCGCT|CAGGCGCATGAAGGACCACAAGTACCAGGC
AGGCGCATGAAGGACAATCCCGTGCTTTCC|CCCCTTGCAGACGAATATAATCCGAACTAG
AGTACCACAAGTACCAGGCGCATGAAGGAC|GGTGCCCTTATTAAGTCTTACGCCCTTCCA
GGCATGGGTGGAGTAGTGTGGTGCCCTTAT|GTTCATGTGGCCACAGACACCAACGCGTAG
GGACAATCCAGGACAATCCCGAGGGCACAA|GGCTATGCTTGTCGCTACGCAGCTTAAGAT
AGGACAATCCAATCCCAGGCGCATGAAGGA|GCGCATGAAGGACAATCCCCTTGCAGACGA
ATCCGGCGCATGAAGGACAATCCGCCCATC|GCATCACAAGTACCAGGCGCATGAAGGACA
ACCTGTGCAGTAGTAGAAATCTAGTTTTGA|AATCCAGGACAATCCCGAGGGCACAAGTAC
TGCTGTGAGTAAAGATCACTTAGCACAAGT|GTAGTAGAAATCTAGTTTTGACGCACGGCG
ACAAGTACCAGGCGCATGAAGGACAATCCA|CATGAAGGACAATCCTTACAGGCTATGCTT
TATAATCCGAACTAGCGCGCGCTCCCAAAT|GCGACCCAGCTTTGTTTGATGAGGATAGAA
CTAGTTTTGACGCACGGCGCCCTAAGTTTT|GCACAAGTACCAGGCGCATGAAGGACAATC
CAACGCCGTGATTTGGAGTCATAACTCCCG|CATCTACGCCGCCGGGAGAACTTGAATCTA
TCAAGATGTGCGCGACCCACAAGTACCAGG|TGCCACAAGTACCAGGCGCATGAAGGACAA
GGAAAACCATCACGAGCTTGGGGCTACCAA|GCGGAAGCGACTTACAGACAACAGCCTATG
TAGAAATCTAGTTTTGACGCACGGCGCCCT|CCCGAGGGCACAAGTACCAGGCGCATGAAG
GTACCAGGCGCATGAAGGACAATCCAATCC|GGGCACAAGTACCAGGCGCATGAAGGACAA
TGTATGCTGTGAGTAAAGATCACTTAGCAC|TGCAGTAGTAGAAATCTAGTTTTGACGCAC
TAAGGCAAGTGTTCAGTAATCATTGAGTCG|AAGCTTGTGGATTCGAGCAACGCCGTGATT
CAGATGCTAGTGAGCGGAAGCGACTTACAG|CAAGTGTCTCCCCCCCTCCGGTGCTGGCCA
GCGCATCACAAGTACCAGGCGCATGAAGGA|GAAGCACCGAAGGGCGATATAAGTCACAAG
GTGCCACAAGTACCAGGCGCATGAAGGACA|AACCGACATGGGACAAGTAAACCACGCACA
AGTAGTGTGGTGCCCTTATTAAGTCTTACG|CACAGACACCAACGCGTAGAGTCGGCTCCA
GCCCTTCCACTGCAGGGCACAAGTACCAGG|AAGGTATGCAGCGCAACAAAACCCGTCACC
GCATGAAGGACAATCCTACACAAGTACCAG|AAACCACGCACAAGTACCAGGCGCATGAAG
CTTGAATCTACAAAGACCTGTGCAGTAGTA|AGGCGCATGAAGGACAATCCAGGACAATCC
CCACAAGTACCAGGCGCATGAAGGACAATC|ACTGCAGGGCACAAGTACCAGGCGCATGAA
TCAGCTGGCGGGCCACAAGTACCACAAGTA|CATGGGTGGAGTAGTGTGGTGCCCTTATTA
CACCGAAGGGCGATATAAGTCACAAGTACC|CTTACGTACTTCAGCTGGCGGGCCACAAGT
CCCCCCTCCGGTGCTGGCCAAGCAGTAACT|TCATTGAGTCGTACACCAGTTCCGACTTTT
TGAAGGACCACAAGTACCAGGCGCATGAAG|CCCTTCCACTGCAGGGCACAAGTACCAGGC
CTACACAAGTACCAGGCGCATGAAGGACAA|ACCAGGCGCATGAAGGACAATCCGATAAGG
CAATCCCAGGCGCATGAAGGACAATCCCGT|GGACAATCCCCTTGCAGACGAATATAATCC
GCACTTGTAAAGCAGTCCTTACGTACTTCA|CGTGCTTTCCGGATTATACCTGGGTGGCAT
GAAGCGACTTACAGACAACAGCCTATGCGT|TCCGGTGCTGGCCAAGCAGTAACTTATGAT
TCACCACTGCGTCAAGATGTGCGCGACCCA|AACAGTTCTTGTGCCACAAGTACCAGGCGC
CCACAATATTAGAAGCACCGAAGGGCGATA|ACTTGTAAAGCAGTCCTTACGTACTTCAGC
AAACCATCACGAGCTTGGGGCTACCAAATT|GAAGCGACTTACAGACAACAGCCTATGCGT
TTAAGTCTTACGCCCTTCCACTGCAGGGCA|GAGTCGGCTCCAAGGTATGCAGCGCAACAA
AACTAGCGCGCGCTCCCAAATGTTCATGTG|CTTTGTTTGATGAGGATAGAAGGACACTGG
AAGGACAATCCAATCCCAGGCGCATGAAGG|GGCGCATGAAGGACAATCCCCTTGCAGACG
CCGAAGGGCGATATAAGTCACAAGTACCAG|TACGTACTTCAGCTGGCGGGCCACAAGTAC
GAAGGACCACAAGTACCAGGCGCATGAAGG|CCTTCCACTGCAGGGCACAAGTACCAGGCG
ACCATGCACAAGCTTGTGGATTCGAGCAAC|ATCCGGCGCATGAAGGACAATCCGCCCATC
ATGCGTCGTTCCCAACAGTTCTTGTGCCAC|TATGATGCCTGATTATGAGAGGCAACCGAC
ACAATCCCCTTGCAGACGAATATAATCCGA|AATTAGGTCGTTGAAAATATGCGACCCAGC
GTGGTGCCCTTATTAAGTCTTACGCCCTTC|CACCAACGCGTAGAGTCGGCTCCAAGGTAT
TTTTGCTGCCGGCACCCGTGAATGAAACTG|GCCTGATAAGCTGTATGCTGTGAGTAAAGA
GCTACGCAGCTTAAGATAGCGCTCCGAGGC|GGCGCATGAAGGACAATCCAATCCCAGGCG
AGGAGGTAGGAAACGTGCATGCGACGCACC|ACACAAGTACCAGGCGCATGAAGGACAATC
CTATGCTTGTCGCTACGCAGCTTAAGATAG|CACAAGTACCAGGCGCATGAAGGACAATCC
GGCGCATGAAGGACAATCCTACACAAGTAC|AGTAAACCACGCACAAGTACCAGGCGCATG
GACAATCCTCGCTTAATCCCACCGAGGCAG|AGTACCAGGCGCATGAAGGACAATCCCCAA
CGTGAATGAAACTGTACCCTTCGGCTGTAG|GCTGTGAGTAAAGATCACTTAGCACAAGTA
GTTTTGACGCACGGCGCCCTAAGTTTTAAC|CAAGTACCAGGCGCATGAAGGACAATCCGT
GCGCCCTAAGTTTTAACTGCACAAGTACCA|CATGAAGGACAATCCGTATTCCACAATATT
CGATATAAGTCACAAGTACCAGGCGCATGA|TCAGCTGGCGGGCCACAAGTACCACAAGTA
TAGTGAGCGGAAGCGACTTACAGACAACAG|CTCCCCCCCTCCGGTGCTGGCCAAGCAGTA
ACAATCCAATCCCAGGCGCATGAAGGACAA|CATGAAGGACAATCCCCTTGCAGACGAATA
GACAATCCCCTTGCAGACGAATATAATCCG|GAATTAGGTCGTTGAAAATATGCGACCCAG
TGAAACTGTACCCTTCGGCTGTAGCGAGGA|AGTAAAGATCACTTAGCACAAGTACCACAC
GCTAGTGAGCGGAAGCGACTTACAGACAAC|GTCTCCCCCCCTCCGGTGCTGGCCAAGCAG
CCGCCGGGAGAACTTGAATCTACAAAGACC|GACACAAGTACCAGGCGCATGAAGGACAAT
AGGAAACGTGCATGCGACGCACCATGCACA|TACCAGGCGCATGAAGGACAATCCGGCGCA
CTTGTCGCTACGCAGCTTAAGATAGCGCTC|GTACCAGGCGCATGAAGGACAATCCAATCC
ATTATACCTGGGTGGCATGGGTGGAGTAGT|CGCGCTCCCAAATGTTCATGTGGCCACAGA
TCACAAGTACCAGGCGCATGAAGGACAATC|GGGCCACAAGTACCACAAGTACCAGGCGCA
AGAGGCAACCGACATGGGACAAGTAAACCA|AATGAAACTGTACCCTTCGGCTGTAGCGAG
GAAGGACAATCCGGCGCATGAAGGACAATC|TACCAGGCGCATCACAAGTACCAGGCGCAT
GTAAACCACGCACAAGTACCAGGCGCATGA|GTAGCGAGGAGGTAGGAAACGTGCATGCGA
CTGCACAAGTACCAGGCGCATCACAAGTAC|TATTCCACAATATTAGAAGCACCGAAGGGC
CCAGGCGCATGAAGGACAATCCGATAAGGC|ACGTGCATGCGACGCACCATGCACAAGCTT
CGGATGTTGGAAAACCATCACGAGCTTGGG|GCTAGTGAGCGGAAGCGACTTACAGACAAC
TGCCGGCACCCGTGAATGAAACTGTACCCT|TAAGCTGTATGCTGTGAGTAAAGATCACTT
CTTGCAGACGAATATAATCCGAACTAGCGC|CGTTGAAAATATGCGACCCAGCTTTGTTTG
TCGTTCCCAACAGTTCTTGTGCCACAAGTA|TGCCTGATTATGAGAGGCAACCGACATGGG
GTTCCGACTTTTTGCTGCCGGCACCCGTGA|ATAACTCCCGCCTGATAAGCTGTATGCTGT
GACAATCCAGGACAATCCCGAGGGCACAAG|GCTATGCTTGTCGCTACGCAGCTTAAGATA
CTGATTATGAGAGGCAACCGACATGGGACA|GCACCCGTGAATGAAACTGTACCCTTCGGC
CAATCCGATAAGGCAAGTGTTCAGTAATCA|CCATGCACAAGCTTGTGGATTCGAGCAACG
AGGCACGTACGAATGCCTGGCACTTGTAAA|GGCGCATGAAGGACAATCCCGTGCTTTCCG
CTAGTGAGCGGAAGCGACTTACAGACAACA|TCTCCCCCCCTCCGGTGCTGGCCAAGCAGT
CACAAGTACCAGGCGCATGAAGGACCACAA|CCTTATTAAGTCTTACGCCCTTCCACTGCA
AGGCGCATGAAGGACAATCCAGGACAATCC|CAATCCTTACAGGCTATGCTTGTCGCTACG
TACCAGGCGCATGAAGGACAATCCCCTTGC|CGTCACCAAGTCTCCGGAATTAGGTCGTTG
GCGCATGAAGGACAATCCGTATTCCACAAT|CGAGGCACGTACGAATGCCTGGCACTTGTA
TCTACAAAGACCTGTGCAGTAGTAGAAATC|ATGAAGGACAATCCAGGACAATCCCGAGGG
AAGTGTCTCCCCCCCTCCGGTGCTGGCCAA|GTTCAGTAATCATTGAGTCGTACACCAGTT
GGAGGTAGGAAACGTGCATGCGACGCACCA|CACAAGTACCAGGCGCATGAAGGACAATCC
GCACGGCGCCCTAAGTTTTAACTGCACAAG|AGGCGCATGAAGGACAATCCGTATTCCACA
AAATTAAGTCCCTCACCACTGCGTCAAGAT|TGCGTCGTTCCCAACAGTTCTTGTGCCACA
GCCGGCACCCGTGAATGAAACTGTACCCTT|AAGCTGTATGCTGTGAGTAAAGATCACTTA
TACCTGGGTGGCATGGGTGGAGTAGTGTGG|CTCCCAAATGTTCATGTGGCCACAGACACC
CTCGCTTAATCCCACCGAGGCAGATGCTAG|GGCGCATGAAGGACAATCCCCAAGTGTCTC
CGCATGAAGGACAATCCAATCCCAGGCGCA|GTACCAGGCGCATGAAGGACAATCCCCTTG
CCTGATAAGCTGTATGCTGTGAGTAAAGAT|CAAAGACCTGTGCAGTAGTAGAAATCTAGT
AAGGACAATCCTCGCTTAATCCCACCGAGG|ACAAGTACCAGGCGCATGAAGGACAATCCC
GGAGAACTTGAATCTACAAAGACCTGTGCA|AGTACCAGGCGCATGAAGGACAATCCAGGA
GCTGGCCAAGCAGTAACTTATGATGCCTGA|ACACCAGTTCCGACTTTTTGCTGCCGGCAC
TACGCCGCCGGGAGAACTTGAATCTACAAA|ATCCGACACAAGTACCAGGCGCATGAAGGA
TCCGCCCATCTACGCCGCCGGGAGAACTTG|ATGAAGGACAATCCGACACAAGTACCAGGC
CAGGCGCATGAAGGACAATCCCCTTGCAGA|CACCAAGTCTCCGGAATTAGGTCGTTGAAA
TGAAGGACAATCCTACACAAGTACCAGGCG|CCACGCACAAGTACCAGGCGCATGAAGGAC
GTAAAGATCACTTAGCACAAGTACCACACA|AATCTAGTTTTGACGCACGGCGCCCTAAGT
ATAATCCGAACTAGCGCGCGCTCCCAAATG|CGACCCAGCTTTGTTTGATGAGGATAGAAG
TAAAGCAGTCCTTACGTACTTCAGCTGGCG|TCCGGATTATACCTGGGTGGCATGGGTGGA
ATGAAGGACAATCCTTACAGGCTATGCTTG|AGTACCAGGCGCATGAAGGACCACAAGTAC
GGATTATACCTGGGTGGCATGGGTGGAGTA|CGCGCGCTCCCAAATGTTCATGTGGCCACA
CGCGCGCTCCCAAATGTTCATGTGGCCACA|TTGATGAGGATAGAAGGACACTGGGCGACC
ATCACTTAGCACAAGTACCACACAAGTACC|GTTTTGACGCACGGCGCCCTAAGTTTTAAC
TCGGATGTTGGAAAACCATCACGAGCTTGG|TGCTAGTGAGCGGAAGCGACTTACAGACAA
ACGTGCATGCGACGCACCATGCACAAGCTT|GGCGCATGAAGGACAATCCGGCGCATGAAG
ACAAGTACCACACAAGTACCAGGCGCATGA|ACGGCGCCCTAAGTTTTAACTGCACAAGTA
AGACCTGTGCAGTAGTAGAAATCTAGTTTT|ACAATCCAGGACAATCCCGAGGGCACAAGT
TACCAGGCGCATGAAGGACAATCCGGCGCA|TAACTGCACAAGTACCAGGCGCATCACAAG
CGTACGAATGCCTGGCACTTGTAAAGCAGT|ATGAAGGACAATCCCGTGCTTTCCGGATTA
CATGAAGGACAATCCAATCCCAGGCGCATG|ACCAGGCGCATGAAGGACAATCCCCTTGCA
CACAAGTACCAGGCGCATGAAGGACAATCC|CTGCAGGGCACAAGTACCAGGCGCATGAAG
GCATGAAGGACAATCCCGTGCTTTCCGGAT|TTGCAGACGAATATAATCCGAACTAGCGCG
CCGAGGCAGATGCTAGTGAGCGGAAGCGAC|AATCCCCAAGTGTCTCCCCCCCTCCGGTGC
ACCAGGCGCATGAAGGACAATCCTTACAGG|AGTACCACAAGTACCAGGCGCATGAAGGAC
CTGGCCAAGCAGTAACTTATGATGCCTGAT|CACCAGTTCCGACTTTTTGCTGCCGGCACC
AAGGCAAGTGTTCAGTAATCATTGAGTCGT|AGCTTGTGGATTCGAGCAACGCCGTGATTT
CGACTTTTTGCTGCCGGCACCCGTGAATGA|CTCCCGCCTGATAAGCTGTATGCTGTGAGT
CTCCCAAATGTTCATGTGGCCACAGACACC|AGGATAGAAGGACACTGGGCGACCCGCCAA
TGCTGCCGGCACCCGTGAATGAAACTGTAC|TGATAAGCTGTATGCTGTGAGTAAAGATCA
CCAGGCGCATGAAGGACAATCCTACACAAG|ACAAGTAAACCACGCACAAGTACCAGGCGC
GCCTATGCGTCGTTCCCAACAGTTCTTGTG|AACTTATGATGCCTGATTATGAGAGGCAAC
GTATTCCACAATATTAGAAGCACCGAAGGG|CTGGCACTTGTAAAGCAGTCCTTACGTACT
AGGCGCATGAAGGACAATCCAATCCCAGGC|CAAGTACCAGGCGCATGAAGGACAATCCCC
CCCTTCCACTGCAGGGCACAAGTACCAGGC|AGGTATGCAGCGCAACAAAACCCGTCACCA
AGCGCGCGCTCCCAAATGTTCATGTGGCCA|GTTTGATGAGGATAGAAGGACACTGGGCGA
TGCGTCAAGATGTGCGCGACCCACAAGTAC|CTTGTGCCACAAGTACCAGGCGCATGAAGG
ATGAAGGACAATCCGGCGCATGAAGGACAA|AGTACCAGGCGCATCACAAGTACCAGGCGC
GGCCAAGCAGTAACTTATGATGCCTGATTA|CCAGTTCCGACTTTTTGCTGCCGGCACCCG
TGCTAGTGAGCGGAAGCGACTTACAGACAA|TGTCTCCCCCCCTCCGGTGCTGGCCAAGCA
CTAAGTTTTAACTGCACAAGTACCAGGCGC|AGGACAATCCGTATTCCACAATATTAGAAG
CAGGCGCATGAAGGACAATCCGTATTCCAC|CTCCGAGGCACGTACGAATGCCTGGCACTT
CGCATGAAGGACAATCCGCCCATCTACGCC|CAAGTACCAGGCGCATGAAGGACAATCCGA
GACAATCCGTATTCCACAATATTAGAAGCA|ACGAATGCCTGGCACTTGTAAAGCAGTCCT
AGGCGCATGAAGGACAATCCTACACAAGTA|AAGTAAACCACGCACAAGTACCAGGCGCAT
AAGTACCAGGCGCATGAAGGACAATCCGGC|TTTTAACTGCACAAGTACCAGGCGCATCAC
CATGAAGGACAATCCCCAAGTGTCTCCCCC|AATCCGATAAGGCAAGTGTTCAGTAATCAT
TATGCTTGTCGCTACGCAGCTTAAGATAGC|ACAAGTACCAGGCGCATGAAGGACAATCCA
AAACGTGCATGCGACGCACCATGCACAAGC|CAGGCGCATGAAGGACAATCCGGCGCATGA
GACACAAGTACCAGGCGCATGAAGGACAAT|GCGCATGAAGGACAATCCTTACAGGCTATG
AGGACAATCCCCAAGTGTCTCCCCCCCTCC|GATAAGGCAAGTGTTCAGTAATCATTGAGT
TTCATGTGGCCACAGACACCAACGCGTAGA|GACACTGGGCGACCCGCCAAAACACGCGTT
GACCACAAGTACCAGGCGCATGAAGGACAA|CCACTGCAGGGCACAAGTACCAGGCGCATG
CAGGCGCATGAAGGACAATCCTCGCTTAAT|ACAATCCTACACAAGTACCAGGCGCATGAA
TCGAGCAACGCCGTGATTTGGAGTCATAAC|CCGCCCATCTACGCCGCCGGGAGAACTTGA
GCCACAAGTACCAGGCGCATGAAGGACAAT|CCGACATGGGACAAGTAAACCACGCACAAG
GGATTCGAGCAACGCCGTGATTTGGAGTCA|CAATCCGCCCATCTACGCCGCCGGGAGAAC
AGGCGCATCACAAGTACCAGGCGCATGAAG|TAGAAGCACCGAAGGGCGATATAAGTCACA
AGGACCACAAGTACCAGGCGCATGAAGGAC|TTCCACTGCAGGGCACAAGTACCAGGCGCA
TATAAGTCACAAGTACCAGGCGCATGAAGG|GCTGGCGGGCCACAAGTACCACAAGTACCA
CATAACTCCCGCCTGATAAGCTGTATGCTG|ACTTGAATCTACAAAGACCTGTGCAGTAGT
TATGCTGTGAGTAAAGATCACTTAGCACAA|CAGTAGTAGAAATCTAGTTTTGACGCACGG
TTATTAAGTCTTACGCCCTTCCACTGCAGG|GTAGAGTCGGCTCCAAGGTATGCAGCGCAA
GGGTGGCATGGGTGGAGTAGTGTGGTGCCC|AAATGTTCATGTGGCCACAGACACCAACGC
GAAGGACAATCCTCGCTTAATCCCACCGAG|CACAAGTACCAGGCGCATGAAGGACAATCC
CCTAAGTTTTAACTGCACAAGTACCAGGCG|AAGGACAATCCGTATTCCACAATATTAGAA
GTGATTTGGAGTCATAACTCCCGCCTGATA|GCCGCCGGGAGAACTTGAATCTACAAAGAC
AATCTAGTTTTGACGCACGGCGCCCTAAGT|AGGGCACAAGTACCAGGCGCATGAAGGACA
TCCACTGCAGGGCACAAGTACCAGGCGCAT|ATGCAGCGCAACAAAACCCGTCACCAAGTC
GCGCATGAAGGACAATCCCCAAGTGTCTCC|GACAATCCGATAAGGCAAGTGTTCAGTAAT
ATCACGAGCTTGGGGCTACCAAATTAAGTC|GACTTACAGACAACAGCCTATGCGTCGTTC
AGAAATCTAGTTTTGACGCACGGCGCCCTA|CCGAGGGCACAAGTACCAGGCGCATGAAGG
GTCATAACTCCCGCCTGATAAGCTGTATGC|GAACTTGAATCTACAAAGACCTGTGCAGTA
CCTCACCACTGCGTCAAGATGTGCGCGACC|CCAACAGTTCTTGTGCCACAAGTACCAGGC
TTTTGACGCACGGCGCCCTAAGTTTTAACT|AAGTACCAGGCGCATGAAGGACAATCCGTA
CCTGATTATGAGAGGCAACCGACATGGGAC|GGCACCCGTGAATGAAACTGTACCCTTCGG
TGGGACAAGTAAACCACGCACAAGTACCAG|CTTCGGCTGTAGCGAGGAGGTAGGAAACGT
ATCCCCTTGCAGACGAATATAATCCGAACT|TAGGTCGTTGAAAATATGCGACCCAGCTTT
TTGGAAAACCATCACGAGCTTGGGGCTACC|GAGCGGAAGCGACTTACAGACAACAGCCTA
ATATAAGTCACAAGTACCAGGCGCATGAAG|AGCTGGCGGGCCACAAGTACCACAAGTACC
ACAAGTACCAGGCGCATGAAGGACCACAAG|CTTATTAAGTCTTACGCCCTTCCACTGCAG
GAAATCTAGTTTTGACGCACGGCGCCCTAA|CGAGGGCACAAGTACCAGGCGCATGAAGGA
CGCACCATGCACAAGCTTGTGGATTCGAGC|ACAATCCGGCGCATGAAGGACAATCCGCCC
AATCCCAGGCGCATGAAGGACAATCCCGTG|GACAATCCCCTTGCAGACGAATATAATCCG
GTATGCTGTGAGTAAAGATCACTTAGCACA|GCAGTAGTAGAAATCTAGTTTTGACGCACG
GAGAACTTGAATCTACAAAGACCTGTGCAG|GTACCAGGCGCATGAAGGACAATCCAGGAC
CCGACACAAGTACCAGGCGCATGAAGGACA|AGGCGCATGAAGGACAATCCTTACAGGCTA
GACAATCCGGCGCATGAAGGACAATCCGCC|AGGCGCATCACAAGTACCAGGCGCATGAAG
CGAAGGGCGATATAAGTCACAAGTACCAGG|ACGTACTTCAGCTGGCGGGCCACAAGTACC
GGCGCATGAAGGACAATCCTCGCTTAATCC|AATCCTACACAAGTACCAGGCGCATGAAGG
ATGTTGGAAAACCATCACGAGCTTGGGGCT|AGTGAGCGGAAGCGACTTACAGACAACAGC
CAGTAATCATTGAGTCGTACACCAGTTCCG|CGAGCAACGCCGTGATTTGGAGTCATAACT
ATGAAGGACAATCCGATAAGGCAAGTGTTC|GCGACGCACCATGCACAAGCTTGTGGATTC
CCTTACGTACTTCAGCTGGCGGGCCACAAG|TACCTGGGTGGCATGGGTGGAGTAGTGTGG
TCCCGCCTGATAAGCTGTATGCTGTGAGTA|ATCTACAAAGACCTGTGCAGTAGTAGAAAT
AGGCGCATGAAGGACAATCCGGCGCATGAA|TGCACAAGTACCAGGCGCATCACAAGTACC
GCACAAGTACCAGGCGCATGAAGGACAATC|CAAAACCCGTCACCAAGTCTCCGGAATTAG
TGCCTGATTATGAGAGGCAACCGACATGGG|CCGGCACCCGTGAATGAAACTGTACCCTTC
CAGGCGCATGAAGGACAATCCGGCGCATGA|CTGCACAAGTACCAGGCGCATCACAAGTAC
CAGACGAATATAATCCGAACTAGCGCGCGC|GAAAATATGCGACCCAGCTTTGTTTGATGA
GTCCTTACGTACTTCAGCTGGCGGGCCACA|TATACCTGGGTGGCATGGGTGGAGTAGTGT
TACCAGGCGCATGAAGGACAATCCGATAAG|AAACGTGCATGCGACGCACCATGCACAAGC
CTGTGCAGTAGTAGAAATCTAGTTTTGACG|TCCAGGACAATCCCGAGGGCACAAGTACCA
CTTACAGACAACAGCCTATGCGTCGTTCCC|CTGGCCAAGCAGTAACTTATGATGCCTGAT
ACCACAAGTACCAGGCGCATGAAGGACCAC|GCCCTTATTAAGTCTTACGCCCTTCCACTG
GCGCTCCGAGGCACGTACGAATGCCTGGCA|CAATCCCAGGCGCATGAAGGACAATCCCGT
ACGGCGCCCTAAGTTTTAACTGCACAAGTA|GCGCATGAAGGACAATCCGTATTCCACAAT
TACAAAGACCTGTGCAGTAGTAGAAATCTA|GAAGGACAATCCAGGACAATCCCGAGGGCA
GGACCACAAGTACCAGGCGCATGAAGGACA|TCCACTGCAGGGCACAAGTACCAGGCGCAT
CATGAAGGACCACAAGTACCAGGCGCATGA|CGCCCTTCCACTGCAGGGCACAAGTACCAG
AAGTACCAGGCGCATGAAGGACAATCCAAT|CAGGGCACAAGTACCAGGCGCATGAAGGAC
GCTACCAAATTAAGTCCCTCACCACTGCGT|AGCCTATGCGTCGTTCCCAACAGTTCTTGT
TCCGGTGCTGGCCAAGCAGTAACTTATGAT|AGTCGTACACCAGTTCCGACTTTTTGCTGC
TGGCGGGCCACAAGTACCACAAGTACCAGG|GTGGAGTAGTGTGGTGCCCTTATTAAGTCT
AGGCGCATGAAGGACAATCCTCGCTTAATC|CAATCCTACACAAGTACCAGGCGCATGAAG
CTGCCGGCACCCGTGAATGAAACTGTACCC|ATAAGCTGTATGCTGTGAGTAAAGATCACT
GCAGTAGTAGAAATCTAGTTTTGACGCACG|GGACAATCCCGAGGGCACAAGTACCAGGCG
TGAAGGACAATCCGGCGCATGAAGGACAAT|GTACCAGGCGCATCACAAGTACCAGGCGCA
CCCAAATGTTCATGTGGCCACAGACACCAA|GATAGAAGGACACTGGGCGACCCGCCAAAA
TCCACAATATTAGAAGCACCGAAGGGCGAT|CACTTGTAAAGCAGTCCTTACGTACTTCAG
ACATGGGACAAGTAAACCACGCACAAGTAC|ACCCTTCGGCTGTAGCGAGGAGGTAGGAAA
GCACCGAAGGGCGATATAAGTCACAAGTAC|CCTTACGTACTTCAGCTGGCGGGCCACAAG
CCGGCACCCGTGAATGAAACTGTACCCTTC|AGCTGTATGCTGTGAGTAAAGATCACTTAG
GACAATCCTACACAAGTACCAGGCGCATGA|CACAAGTACCAGGCGCATGAAGGACAATCC
GCATGAAGGACAATCCGTATTCCACAATAT|AGGCACGTACGAATGCCTGGCACTTGTAAA
GCATGAAGGACAATCCGATAAGGCAAGTGT|ATGCGACGCACCATGCACAAGCTTGTGGAT
AAGTCACAAGTACCAGGCGCATGAAGGACA|GGCGGGCCACAAGTACCACAAGTACCAGGC
CCGGTGCTGGCCAAGCAGTAACTTATGATG|GTCGTACACCAGTTCCGACTTTTTGCTGCC
ACCAGGCGCATGAAGGACAATCCCCAAGTG|TGAAGGACAATCCGATAAGGCAAGTGTTCA
ATCCCGTGCTTTCCGGATTATACCTGGGTG|ATAATCCGAACTAGCGCGCGCTCCCAAATG
AAGTCTTACGCCCTTCCACTGCAGGGCACA|GTCGGCTCCAAGGTATGCAGCGCAACAAAA
AATCCCCTTGCAGACGAATATAATCCGAAC|TTAGGTCGTTGAAAATATGCGACCCAGCTT
AATATAATCCGAACTAGCGCGCGCTCCCAA|ATGCGACCCAGCTTTGTTTGATGAGGATAG
CACCACTGCGTCAAGATGTGCGCGACCCAC|ACAGTTCTTGTGCCACAAGTACCAGGCGCA
CTTAAGATAGCGCTCCGAGGCACGTACGAA|AGGACAATCCAATCCCAGGCGCATGAAGGA
GGATGTTGGAAAACCATCACGAGCTTGGGG|CTAGTGAGCGGAAGCGACTTACAGACAACA
TCTACGCCGCCGGGAGAACTTGAATCTACA|CAATCCGACACAAGTACCAGGCGCATGAAG
AAGTCCCTCACCACTGCGTCAAGATGTGCG|CGTTCCCAACAGTTCTTGTGCCACAAGTAC
GAAGGACAATCCTACACAAGTACCAGGCGC|CACGCACAAGTACCAGGCGCATGAAGGACA
TCGTACACCAGTTCCGACTTTTTGCTGCCG|ATTTGGAGTCATAACTCCCGCCTGATAAGC
GAGCTTGGGGCTACCAAATTAAGTCCCTCA|ACAGACAACAGCCTATGCGTCGTTCCCAAC
AGTAAACCACGCACAAGTACCAGGCGCATG|TGTAGCGAGGAGGTAGGAAACGTGCATGCG
CGTGCATGCGACGCACCATGCACAAGCTTG|GCGCATGAAGGACAATCCGGCGCATGAAGG
TGTACCCTTCGGCTGTAGCGAGGAGGTAGG|GATCACTTAGCACAAGTACCACACAAGTAC
TCCCCTTGCAGACGAATATAATCCGAACTA|AGGTCGTTGAAAATATGCGACCCAGCTTTG
GGCGGGCCACAAGTACCACAAGTACCAGGC|TGGAGTAGTGTGGTGCCCTTATTAAGTCTT
CCTTCGGCTGTAGCGAGGAGGTAGGAAACG|CTTAGCACAAGTACCACACAAGTACCAGGC
AATCCCGAGGGCACAAGTACCAGGCGCATG|CTACGCAGCTTAAGATAGCGCTCCGAGGCA
CAATCCCGTGCTTTCCGGATTATACCTGGG|ATATAATCCGAACTAGCGCGCGCTCCCAAA
GCATGAAGGACAATCCTCGCTTAATCCCAC|CCTACACAAGTACCAGGCGCATGAAGGACA
CGCATGAAGGACAATCCGACACAAGTACCA|TAAGTCACAAGTACCAGGCGCATGAAGGAC
ACACCAGTTCCGACTTTTTGCTGCCGGCAC|GGAGTCATAACTCCCGCCTGATAAGCTGTA
TGCACAAGCTTGTGGATTCGAGCAACGCCG|GGCGCATGAAGGACAATCCGCCCATCTACG
GTGAGTAAAGATCACTTAGCACAAGTACCA|TAGAAATCTAGTTTTGACGCACGGCGCCCT
TGATTTGGAGTCATAACTCCCGCCTGATAA|CCGCCGGGAGAACTTGAATCTACAAAGACC
TAATCATTGAGTCGTACACCAGTTCCGACT|GCAACGCCGTGATTTGGAGTCATAACTCCC
ACAAGTACCAGGCGCATGAAGGACAATCCG|AGTTTTAACTGCACAAGTACCAGGCGCATC
TGAAGGACAATCCCCAAGTGTCTCCCCCCC|TCCGATAAGGCAAGTGTTCAGTAATCATTG
ATAAGTCACAAGTACCAGGCGCATGAAGGA|CTGGCGGGCCACAAGTACCACAAGTACCAG
CGGCACCCGTGAATGAAACTGTACCCTTCG|GCTGTATGCTGTGAGTAAAGATCACTTAGC
TTCCGGATTATACCTGGGTGGCATGGGTGG|CTAGCGCGCGCTCCCAAATGTTCATGTGGC
AGTACCAGGCGCATGAAGGACAATCCTACA|TGGGACAAGTAAACCACGCACAAGTACCAG
TATGATGCCTGATTATGAGAGGCAACCGAC|TGCTGCCGGCACCCGTGAATGAAACTGTAC
AGTACCAGGCGCATGAAGGACAATCCTCGC|GAAGGACAATCCTACACAAGTACCAGGCGC
CATCACGAGCTTGGGGCTACCAAATTAAGT|CGACTTACAGACAACAGCCTATGCGTCGTT
ACAAGTACCAGGCGCATGAAGGACAATCCC|GGCGCATGAAGGACAATCCGATAAGGCAAG
CTTCGGCTGTAGCGAGGAGGTAGGAAACGT|TTAGCACAAGTACCACACAAGTACCAGGCG
CCCGTGAATGAAACTGTACCCTTCGGCTGT|ATGCTGTGAGTAAAGATCACTTAGCACAAG
GTACCCTTCGGCTGTAGCGAGGAGGTAGGA|ATCACTTAGCACAAGTACCACACAAGTACC
TTCCCAACAGTTCTTGTGCCACAAGTACCA|CTGATTATGAGAGGCAACCGACATGGGACA
AGTGTGGTGCCCTTATTAAGTCTTACGCCC|AGACACCAACGCGTAGAGTCGGCTCCAAGG
GGCGCATCACAAGTACCAGGCGCATGAAGG|AGAAGCACCGAAGGGCGATATAAGTCACAA
ATCCCAGGCGCATGAAGGACAATCCCGTGC|ACAATCCCCTTGCAGACGAATATAATCCGA
AGTAATCATTGAGTCGTACACCAGTTCCGA|GAGCAACGCCGTGATTTGGAGTCATAACTC
AGTCATAACTCCCGCCTGATAAGCTGTATG|AGAACTTGAATCTACAAAGACCTGTGCAGT
CAAGTACCACAAGTACCAGGCGCATGAAGG|GTGGTGCCCTTATTAAGTCTTACGCCCTTC
GTGGCATGGGTGGAGTAGTGTGGTGCCCTT|ATGTTCATGTGGCCACAGACACCAACGCGT
GAGCAACGCCGTGATTTGGAGTCATAACTC|GCCCATCTACGCCGCCGGGAGAACTTGAAT
TAAGTTTTAACTGCACAAGTACCAGGCGCA|GGACAATCCGTATTCCACAATATTAGAAGC
TACCAAATTAAGTCCCTCACCACTGCGTCA|CCTATGCGTCGTTCCCAACAGTTCTTGTGC
AGCGCTCCGAGGCACGTACGAATGCCTGGC|CCAATCCCAGGCGCATGAAGGACAATCCCG
TGAATCTACAAAGACCTGTGCAGTAGTAGA|GCGCATGAAGGACAATCCAGGACAATCCCG
ACCTGGGTGGCATGGGTGGAGTAGTGTGGT|TCCCAAATGTTCATGTGGCCACAGACACCA
GCGGGCCACAAGTACCACAAGTACCAGGCG|GGAGTAGTGTGGTGCCCTTATTAAGTCTTA
CCAAATGTTCATGTGGCCACAGACACCAAC|ATAGAAGGACACTGGGCGACCCGCCAAAAC
TAAAGATCACTTAGCACAAGTACCACACAA|ATCTAGTTTTGACGCACGGCGCCCTAAGTT
AGGACAATCCGATAAGGCAAGTGTTCAGTA|CGCACCATGCACAAGCTTGTGGATTCGAGC
GCACAAGTACCAGGCGCATCACAAGTACCA|TTCCACAATATTAGAAGCACCGAAGGGCGA
GAAAACCATCACGAGCTTGGGGCTACCAAA|CGGAAGCGACTTACAGACAACAGCCTATGC
TTATGATGCCTGATTATGAGAGGCAACCGA|TTGCTGCCGGCACCCGTGAATGAAACTGTA
ATCATTGAGTCGTACACCAGTTCCGACTTT|AACGCCGTGATTTGGAGTCATAACTCCCGC
TAACTGCACAAGTACCAGGCGCATCACAAG|CCGTATTCCACAATATTAGAAGCACCGAAG
CAAGCTTGTGGATTCGAGCAACGCCGTGAT|CATGAAGGACAATCCGCCCATCTACGCCGC
ATGAAACTGTACCCTTCGGCTGTAGCGAGG|GAGTAAAGATCACTTAGCACAAGTACCACA
CCTCCGGTGCTGGCCAAGCAGTAACTTATG|TGAGTCGTACACCAGTTCCGACTTTTTGCT
CACAAGTACCACAAGTACCAGGCGCATGAA|GTGTGGTGCCCTTATTAAGTCTTACGCCCT
GTGCAGTAGTAGAAATCTAGTTTTGACGCA|CAGGACAATCCCGAGGGCACAAGTACCAGG
TCCGAACTAGCGCGCGCTCCCAAATGTTCA|CCAGCTTTGTTTGATGAGGATAGAAGGACA
TGCTTTCCGGATTATACCTGGGTGGCATGG|CGAACTAGCGCGCGCTCCCAAATGTTCATG
CCCATCTACGCCGCCGGGAGAACTTGAATC|AGGACAATCCGACACAAGTACCAGGCGCAT
TCCCGTGCTTTCCGGATTATACCTGGGTGG|TAATCCGAACTAGCGCGCGCTCCCAAATGT
CGTTCCCAACAGTTCTTGTGCCACAAGTAC|GCCTGATTATGAGAGGCAACCGACATGGGA
GCGCGCGCTCCCAAATGTTCATGTGGCCAC|TTTGATGAGGATAGAAGGACACTGGGCGAC
CACGTACGAATGCCTGGCACTTGTAAAGCA|GCATGAAGGACAATCCCGTGCTTTCCGGAT
AGATAGCGCTCCGAGGCACGTACGAATGCC|CAATCCAATCCCAGGCGCATGAAGGACAAT
ACAATATTAGAAGCACCGAAGGGCGATATA|TTGTAAAGCAGTCCTTACGTACTTCAGCTG
CCTTACAGGCTATGCTTGTCGCTACGCAGC|ATGAAGGACCACAAGTACCAGGCGCATGAA
GATAGCGCTCCGAGGCACGTACGAATGCCT|AATCCAATCCCAGGCGCATGAAGGACAATC
GCTTGTCGCTACGCAGCTTAAGATAGCGCT|AGTACCAGGCGCATGAAGGACAATCCAATC
CTACCAAATTAAGTCCCTCACCACTGCGTC|GCCTATGCGTCGTTCCCAACAGTTCTTGTG
TGGTGCCCTTATTAAGTCTTACGCCCTTCC|ACCAACGCGTAGAGTCGGCTCCAAGGTATG
TCCAATCCCAGGCGCATGAAGGACAATCCC|AAGGACAATCCCCTTGCAGACGAATATAAT
TTCGGCTGTAGCGAGGAGGTAGGAAACGTG|TAGCACAAGTACCACACAAGTACCAGGCGC
CACAAGTACCACACAAGTACCAGGCGCATG|CACGGCGCCCTAAGTTTTAACTGCACAAGT
TTGCTGCCGGCACCCGTGAATGAAACTGTA|CTGATAAGCTGTATGCTGTGAGTAAAGATC
CCCAAGTGTCTCCCCCCCTCCGGTGCTGGC|AGTGTTCAGTAATCATTGAGTCGTACACCA
CGCATGAAGGACAATCCTTACAGGCTATGC|ACAAGTACCAGGCGCATGAAGGACCACAAG
AGTGTCTCCCCCCCTCCGGTGCTGGCCAAG|TTCAGTAATCATTGAGTCGTACACCAGTTC
CTCACCACTGCGTCAAGATGTGCGCGACCC|CAACAGTTCTTGTGCCACAAGTACCAGGCG
GCTGTGAGTAAAGATCACTTAGCACAAGTA|TAGTAGAAATCTAGTTTTGACGCACGGCGC
GTGTGGTGCCCTTATTAAGTCTTACGCCCT|GACACCAACGCGTAGAGTCGGCTCCAAGGT
GGACAATCCCCTTGCAGACGAATATAATCC|GGAATTAGGTCGTTGAAAATATGCGACCCA
GCCACAAGTACCACAAGTACCAGGCGCATG|TAGTGTGGTGCCCTTATTAAGTCTTACGCC
AGTACCAGGCGCATGAAGGACAATCCCCTT|CCCGTCACCAAGTCTCCGGAATTAGGTCGT
GCGCATGAAGGACAATCCCGTGCTTTCCGG|CCTTGCAGACGAATATAATCCGAACTAGCG
CCAGGCGCATCACAAGTACCAGGCGCATGA|ATTAGAAGCACCGAAGGGCGATATAAGTCA
CAATCCCCAAGTGTCTCCCCCCCTCCGGTG|AGGCAAGTGTTCAGTAATCATTGAGTCGTA
GGACAATCCGATAAGGCAAGTGTTCAGTAA|GCACCATGCACAAGCTTGTGGATTCGAGCA
GCAGGGCACAAGTACCAGGCGCATGAAGGA|CGCAACAAAACCCGTCACCAAGTCTCCGGA
ATACCTGGGTGGCATGGGTGGAGTAGTGTG|GCTCCCAAATGTTCATGTGGCCACAGACAC
AGTCTTACGCCCTTCCACTGCAGGGCACAA|TCGGCTCCAAGGTATGCAGCGCAACAAAAC
GAGTAAAGATCACTTAGCACAAGTACCACA|GAAATCTAGTTTTGACGCACGGCGCCCTAA
TTGTGCCACAAGTACCAGGCGCATGAAGGA|GCAACCGACATGGGACAAGTAAACCACGCA
CAATCCGGCGCATGAAGGACAATCCGCCCA|GCGCATCACAAGTACCAGGCGCATGAAGGA
GATGCCTGATTATGAGAGGCAACCGACATG|TGCCGGCACCCGTGAATGAAACTGTACCCT
GACAAGTAAACCACGCACAAGTACCAGGCG|CGGCTGTAGCGAGGAGGTAGGAAACGTGCA
GCCAAGCAGTAACTTATGATGCCTGATTAT|CAGTTCCGACTTTTTGCTGCCGGCACCCGT
CAGTTCTTGTGCCACAAGTACCAGGCGCAT|TGAGAGGCAACCGACATGGGACAAGTAAAC
AGACGAATATAATCCGAACTAGCGCGCGCT|AAAATATGCGACCCAGCTTTGTTTGATGAG
TGAAGGACAATCCTCGCTTAATCCCACCGA|ACACAAGTACCAGGCGCATGAAGGACAATC
CCATCACGAGCTTGGGGCTACCAAATTAAG|GCGACTTACAGACAACAGCCTATGCGTCGT
AGTACCAGGCGCATGAAGGACAATCCAGGA|GAAGGACAATCCTTACAGGCTATGCTTGTC
AAGTACCAGGCGCATGAAGGACAATCCTTA|CACAAGTACCACAAGTACCAGGCGCATGAA
AGGCGCATGAAGGACCACAAGTACCAGGCG|TCTTACGCCCTTCCACTGCAGGGCACAAGT
GCCTGGCACTTGTAAAGCAGTCCTTACGTA|AATCCCGTGCTTTCCGGATTATACCTGGGT
AAGGGCGATATAAGTCACAAGTACCAGGCG|GTACTTCAGCTGGCGGGCCACAAGTACCAC
GCCCATCTACGCCGCCGGGAGAACTTGAAT|AAGGACAATCCGACACAAGTACCAGGCGCA
TATACCTGGGTGGCATGGGTGGAGTAGTGT|CGCTCCCAAATGTTCATGTGGCCACAGACA
ACCAGGCGCATGAAGGACAATCCGGCGCAT|AACTGCACAAGTACCAGGCGCATCACAAGT
AAGTACCAGGCGCATGAAGGACAATCCGAC|AAGGGCGATATAAGTCACAAGTACCAGGCG
GAATATAATCCGAACTAGCGCGCGCTCCCA|TATGCGACCCAGCTTTGTTTGATGAGGATA
GATTTGGAGTCATAACTCCCGCCTGATAAG|CGCCGGGAGAACTTGAATCTACAAAGACCT
CCGTGCTTTCCGGATTATACCTGGGTGGCA|ATCCGAACTAGCGCGCGCTCCCAAATGTTC
ATGAAGGACAATCCTCGCTTAATCCCACCG|TACACAAGTACCAGGCGCATGAAGGACAAT
GGGCTACCAAATTAAGTCCCTCACCACTGC|ACAGCCTATGCGTCGTTCCCAACAGTTCTT
ATGTGCGCGACCCACAAGTACCAGGCGCAT|CAAGTACCAGGCGCATGAAGGACAATCCTA
CTACGCCGCCGGGAGAACTTGAATCTACAA|AATCCGACACAAGTACCAGGCGCATGAAGG
ACAACAGCCTATGCGTCGTTCCCAACAGTT|AGCAGTAACTTATGATGCCTGATTATGAGA
CGCATGAAGGACAATCCCGTGCTTTCCGGA|CTTGCAGACGAATATAATCCGAACTAGCGC
GTACTTCAGCTGGCGGGCCACAAGTACCAC|GGTGGCATGGGTGGAGTAGTGTGGTGCCCT
ACAATCCTTACAGGCTATGCTTGTCGCTAC|GGCGCATGAAGGACCACAAGTACCAGGCGC
GGGAGAACTTGAATCTACAAAGACCTGTGC|AAGTACCAGGCGCATGAAGGACAATCCAGG
GAACTAGCGCGCGCTCCCAAATGTTCATGT|GCTTTGTTTGATGAGGATAGAAGGACACTG
TGTGCGCGACCCACAAGTACCAGGCGCATG|AAGTACCAGGCGCATGAAGGACAATCCTAC
GAAACTGTACCCTTCGGCTGTAGCGAGGAG|GTAAAGATCACTTAGCACAAGTACCACACA
GTAGGAAACGTGCATGCGACGCACCATGCA|AGTACCAGGCGCATGAAGGACAATCCGGCG
AACTTATGATGCCTGATTATGAGAGGCAAC|TTTTTGCTGCCGGCACCCGTGAATGAAACT
GACAATCCGACACAAGTACCAGGCGCATGA|AGTACCAGGCGCATGAAGGACAATCCTTAC
GGACAATCCAATCCCAGGCGCATGAAGGAC|CGCATGAAGGACAATCCCCTTGCAGACGAA
AGCGACTTACAGACAACAGCCTATGCGTCG|CGGTGCTGGCCAAGCAGTAACTTATGATGC
TGAGTAAAGATCACTTAGCACAAGTACCAC|AGAAATCTAGTTTTGACGCACGGCGCCCTA
ATCCCGAGGGCACAAGTACCAGGCGCATGA|TACGCAGCTTAAGATAGCGCTCCGAGGCAC
GAGGTAGGAAACGTGCATGCGACGCACCAT|ACAAGTACCAGGCGCATGAAGGACAATCCG
GGACAATCCGTATTCCACAATATTAGAAGC|TACGAATGCCTGGCACTTGTAAAGCAGTCC
TTCCGACTTTTTGCTGCCGGCACCCGTGAA|TAACTCCCGCCTGATAAGCTGTATGCTGTG
AGGCGCATGAAGGACAATCCGACACAAGTA|ATATAAGTCACAAGTACCAGGCGCATGAAG
GTGCATGCGACGCACCATGCACAAGCTTGT|CGCATGAAGGACAATCCGGCGCATGAAGGA
AAAGATCACTTAGCACAAGTACCACACAAG|TCTAGTTTTGACGCACGGCGCCCTAAGTTT
AATTAAGTCCCTCACCACTGCGTCAAGATG|GCGTCGTTCCCAACAGTTCTTGTGCCACAA
TCCGTATTCCACAATATTAGAAGCACCGAA|TGCCTGGCACTTGTAAAGCAGTCCTTACGT
AGCACCGAAGGGCGATATAAGTCACAAGTA|TCCTTACGTACTTCAGCTGGCGGGCCACAA
TCCAGGACAATCCCGAGGGCACAAGTACCA|GCTTGTCGCTACGCAGCTTAAGATAGCGCT
ATGAGAGGCAACCGACATGGGACAAGTAAA|GTGAATGAAACTGTACCCTTCGGCTGTAGC
TTGCAGACGAATATAATCCGAACTAGCGCG|GTTGAAAATATGCGACCCAGCTTTGTTTGA
ATGAAGGACAATCCAATCCCAGGCGCATGA|CCAGGCGCATGAAGGACAATCCCCTTGCAG
AGGCTATGCTTGTCGCTACGCAGCTTAAGA|GACCACAAGTACCAGGCGCATGAAGGACAA
AGAAGCACCGAAGGGCGATATAAGTCACAA|CAGTCCTTACGTACTTCAGCTGGCGGGCCA
ACGCACGGCGCCCTAAGTTTTAACTGCACA|CCAGGCGCATGAAGGACAATCCGTATTCCA
CATGAAGGACAATCCTACACAAGTACCAGG|AACCACGCACAAGTACCAGGCGCATGAAGG
TTAGCACAAGTACCACACAAGTACCAGGCG|GACGCACGGCGCCCTAAGTTTTAACTGCAC
TAATCCCACCGAGGCAGATGCTAGTGAGCG|TGAAGGACAATCCCCAAGTGTCTCCCCCCC
GCCGCCGGGAGAACTTGAATCTACAAAGAC|CGACACAAGTACCAGGCGCATGAAGGACAA
GTACGAATGCCTGGCACTTGTAAAGCAGTC|TGAAGGACAATCCCGTGCTTTCCGGATTAT
TACACAAGTACCAGGCGCATGAAGGACAAT|CCAGGCGCATGAAGGACAATCCGATAAGGC
ATTGAGTCGTACACCAGTTCCGACTTTTTG|GCCGTGATTTGGAGTCATAACTCCCGCCTG
ACAAGTACCAGGCGCATGAAGGACAATCCT|CATGAAGGACAATCCTACACAAGTACCAGG
CCAGGCGCATGAAGGACAATCCCGTGCTTT|ATCCCCTTGCAGACGAATATAATCCGAACT
TAATCCGAACTAGCGCGCGCTCCCAAATGT|GACCCAGCTTTGTTTGATGAGGATAGAAGG
CACTTGTAAAGCAGTCCTTACGTACTTCAG|GTGCTTTCCGGATTATACCTGGGTGGCATG
GCATGAAGGACCACAAGTACCAGGCGCATG|ACGCCCTTCCACTGCAGGGCACAAGTACCA
AAGTACCAGGCGCATGAAGGACAATCCCCT|ACCCGTCACCAAGTCTCCGGAATTAGGTCG
TTCCACAATATTAGAAGCACCGAAGGGCGA|GCACTTGTAAAGCAGTCCTTACGTACTTCA
GGCGCATGAAGGACCACAAGTACCAGGCGC|CTTACGCCCTTCCACTGCAGGGCACAAGTA
AACCATCACGAGCTTGGGGCTACCAAATTA|AAGCGACTTACAGACAACAGCCTATGCGTC
TGCACAAGTACCAGGCGCATCACAAGTACC|ATTCCACAATATTAGAAGCACCGAAGGGCG
TGAATGAAACTGTACCCTTCGGCTGTAGCG|TGTGAGTAAAGATCACTTAGCACAAGTACC
AAGCACCGAAGGGCGATATAAGTCACAAGT|GTCCTTACGTACTTCAGCTGGCGGGCCACA
GGGCGATATAAGTCACAAGTACCAGGCGCA|ACTTCAGCTGGCGGGCCACAAGTACCACAA
ACCCGTGAATGAAACTGTACCCTTCGGCTG|TATGCTGTGAGTAAAGATCACTTAGCACAA
TGGATTCGAGCAACGCCGTGATTTGGAGTC|ACAATCCGCCCATCTACGCCGCCGGGAGAA
TTGTAAAGCAGTCCTTACGTACTTCAGCTG|CTTTCCGGATTATACCTGGGTGGCATGGGT
CAAGCAGTAACTTATGATGCCTGATTATGA|GTTCCGACTTTTTGCTGCCGGCACCCGTGA
CACAATATTAGAAGCACCGAAGGGCGATAT|CTTGTAAAGCAGTCCTTACGTACTTCAGCT
AACGTGCATGCGACGCACCATGCACAAGCT|AGGCGCATGAAGGACAATCCGGCGCATGAA
CCACACAAGTACCAGGCGCATGAAGGACAA|CCTAAGTTTTAACTGCACAAGTACCAGGCG
ACCACTGCGTCAAGATGTGCGCGACCCACA|CAGTTCTTGTGCCACAAGTACCAGGCGCAT
CCAAATTAAGTCCCTCACCACTGCGTCAAG|TATGCGTCGTTCCCAACAGTTCTTGTGCCA
CATCTACGCCGCCGGGAGAACTTGAATCTA|GACAATCCGACACAAGTACCAGGCGCATGA
TATTCCACAATATTAGAAGCACCGAAGGGC|TGGCACTTGTAAAGCAGTCCTTACGTACTT
CGCTACGCAGCTTAAGATAGCGCTCCGAGG|AGGCGCATGAAGGACAATCCAATCCCAGGC
CGAGCTTGGGGCTACCAAATTAAGTCCCTC|TACAGACAACAGCCTATGCGTCGTTCCCAA
GGGCACAAGTACCAGGCGCATGAAGGACAA|AACAAAACCCGTCACCAAGTCTCCGGAATT
CGATAAGGCAAGTGTTCAGTAATCATTGAG|CACAAGCTTGTGGATTCGAGCAACGCCGTG
ATAACTCCCGCCTGATAAGCTGTATGCTGT|CTTGAATCTACAAAGACCTGTGCAGTAGTA
ATGAAGGACAATCCCCAAGTGTCTCCCCCC|ATCCGATAAGGCAAGTGTTCAGTAATCATT
AGGACAATCCTCGCTTAATCCCACCGAGGC|CAAGTACCAGGCGCATGAAGGACAATCCCC
AATCCGCCCATCTACGCCGCCGGGAGAACT|GCATGAAGGACAATCCGACACAAGTACCAG
TTGACGCACGGCGCCCTAAGTTTTAACTGC|GTACCAGGCGCATGAAGGACAATCCGTATT
ATGTTCATGTGGCCACAGACACCAACGCGT|AAGGACACTGGGCGACCCGCCAAAACACGC
ACCAGGCGCATGAAGGACAATCCTCGCTTA|GGACAATCCTACACAAGTACCAGGCGCATG
GCTCCCAAATGTTCATGTGGCCACAGACAC|GAGGATAGAAGGACACTGGGCGACCCGCCA
CAAGTACCAGGCGCATCACAAGTACCAGGC|CACAATATTAGAAGCACCGAAGGGCGATAT
AAGCTGTATGCTGTGAGTAAAGATCACTTA|CCTGTGCAGTAGTAGAAATCTAGTTTTGAC
TCCTCGCTTAATCCCACCGAGGCAGATGCT|CAGGCGCATGAAGGACAATCCCCAAGTGTC
ATTAAGTCCCTCACCACTGCGTCAAGATGT|CGTCGTTCCCAACAGTTCTTGTGCCACAAG
AATCATTGAGTCGTACACCAGTTCCGACTT|CAACGCCGTGATTTGGAGTCATAACTCCCG
AGGACAATCCAGGACAATCCCGAGGGCACA|AGGCTATGCTTGTCGCTACGCAGCTTAAGA
CGTACACCAGTTCCGACTTTTTGCTGCCGG|TTTGGAGTCATAACTCCCGCCTGATAAGCT
TCCCGAGGGCACAAGTACCAGGCGCATGAA|ACGCAGCTTAAGATAGCGCTCCGAGGCACG
ACACAAGTACCAGGCGCATGAAGGACAATC|CGCATGAAGGACAATCCTTACAGGCTATGC
ACAATCCGTATTCCACAATATTAGAAGCAC|CGAATGCCTGGCACTTGTAAAGCAGTCCTT
AAGATCACTTAGCACAAGTACCACACAAGT|CTAGTTTTGACGCACGGCGCCCTAAGTTTT
CAGCCTATGCGTCGTTCCCAACAGTTCTTG|GTAACTTATGATGCCTGATTATGAGAGGCA
CGCATGAAGGACAATCCTCGCTTAATCCCA|TCCTACACAAGTACCAGGCGCATGAAGGAC
ACGTACGAATGCCTGGCACTTGTAAAGCAG|CATGAAGGACAATCCCGTGCTTTCCGGATT
TTGAGTCGTACACCAGTTCCGACTTTTTGC|CCGTGATTTGGAGTCATAACTCCCGCCTGA
GACTTACAGACAACAGCCTATGCGTCGTTC|TGCTGGCCAAGCAGTAACTTATGATGCCTG
CGGCTGTAGCGAGGAGGTAGGAAACGTGCA|GCACAAGTACCACACAAGTACCAGGCGCAT
AATCCTTACAGGCTATGCTTGTCGCTACGC|CGCATGAAGGACCACAAGTACCAGGCGCAT
GCATGAAGGACAATCCGCCCATCTACGCCG|AAGTACCAGGCGCATGAAGGACAATCCGAC
TAACTCCCGCCTGATAAGCTGTATGCTGTG|TTGAATCTACAAAGACCTGTGCAGTAGTAG
CCCCCCCTCCGGTGCTGGCCAAGCAGTAAC|ATCATTGAGTCGTACACCAGTTCCGACTTT
GTAACTTATGATGCCTGATTATGAGAGGCA|ACTTTTTGCTGCCGGCACCCGTGAATGAAA
CCCACAAGTACCAGGCGCATGAAGGACAAT|GCGCATGAAGGACAATCCTACACAAGTACC
AAGGACAATCCGGCGCATGAAGGACAATCC|ACCAGGCGCATCACAAGTACCAGGCGCATG
ACAAGTACCAGGCGCATGAAGGACAATCCG|AGATAGCGCTCCGAGGCACGTACGAATGCC
TGAAGGACAATCCAGGACAATCCCGAGGGC|TACAGGCTATGCTTGTCGCTACGCAGCTTA
CAAGTACCAGGCGCATGAAGGACAATCCGG|GTTTTAACTGCACAAGTACCAGGCGCATCA
GACATGGGACAAGTAAACCACGCACAAGTA|TACCCTTCGGCTGTAGCGAGGAGGTAGGAA
CCTCGCTTAATCCCACCGAGGCAGATGCTA|AGGCGCATGAAGGACAATCCCCAAGTGTCT
CAATCCAATCCCAGGCGCATGAAGGACAAT|ATGAAGGACAATCCCCTTGCAGACGAATAT
AGGCGCATGAAGGACAATCCCCTTGCAGAC|ACCAAGTCTCCGGAATTAGGTCGTTGAAAA
TACCCTTCGGCTGTAGCGAGGAGGTAGGAA|TCACTTAGCACAAGTACCACACAAGTACCA
GTACCACACAAGTACCAGGCGCATGAAGGA|CGCCCTAAGTTTTAACTGCACAAGTACCAG
CCACTGCGTCAAGATGTGCGCGACCCACAA|AGTTCTTGTGCCACAAGTACCAGGCGCATG
AACCACGCACAAGTACCAGGCGCATGAAGG|GCGAGGAGGTAGGAAACGTGCATGCGACGC
ATAGCGCTCCGAGGCACGTACGAATGCCTG|ATCCAATCCCAGGCGCATGAAGGACAATCC
CAAGTGTCTCCCCCCCTCCGGTGCTGGCCA|TGTTCAGTAATCATTGAGTCGTACACCAGT
TAGTGTGGTGCCCTTATTAAGTCTTACGCC|CAGACACCAACGCGTAGAGTCGGCTCCAAG
CTCCGGTGCTGGCCAAGCAGTAACTTATGA|GAGTCGTACACCAGTTCCGACTTTTTGCTG
CTATGCGTCGTTCCCAACAGTTCTTGTGCC|CTTATGATGCCTGATTATGAGAGGCAACCG
CAATATTAGAAGCACCGAAGGGCGATATAA|TGTAAAGCAGTCCTTACGTACTTCAGCTGG
GAACTTGAATCTACAAAGACCTGTGCAGTA|ACCAGGCGCATGAAGGACAATCCAGGACAA
GCATGAAGGACAATCCCCAAGTGTCTCCCC|CAATCCGATAAGGCAAGTGTTCAGTAATCA
CATGCACAAGCTTGTGGATTCGAGCAACGC|CCGGCGCATGAAGGACAATCCGCCCATCTA
GCAGATGCTAGTGAGCGGAAGCGACTTACA|CCAAGTGTCTCCCCCCCTCCGGTGCTGGCC
ACTGTACCCTTCGGCTGTAGCGAGGAGGTA|AAGATCACTTAGCACAAGTACCACACAAGT
ATTCCACAATATTAGAAGCACCGAAGGGCG|GGCACTTGTAAAGCAGTCCTTACGTACTTC
GACAATCCTTACAGGCTATGCTTGTCGCTA|AGGCGCATGAAGGACCACAAGTACCAGGCG
ATCTACGCCGCCGGGAGAACTTGAATCTAC|ACAATCCGACACAAGTACCAGGCGCATGAA
AATCCAATCCCAGGCGCATGAAGGACAATC|TGAAGGACAATCCCCTTGCAGACGAATATA
AGGACAATCCGCCCATCTACGCCGCCGGGA|CAGGCGCATGAAGGACAATCCGACACAAGT
ACAATCCGATAAGGCAAGTGTTCAGTAATC|ACCATGCACAAGCTTGTGGATTCGAGCAAC
GGTGGCATGGGTGGAGTAGTGTGGTGCCCT|AATGTTCATGTGGCCACAGACACCAACGCG
CCGGGAGAACTTGAATCTACAAAGACCTGT|ACAAGTACCAGGCGCATGAAGGACAATCCA
AGAACTTGAATCTACAAAGACCTGTGCAGT|TACCAGGCGCATGAAGGACAATCCAGGACA
CTCCCGCCTGATAAGCTGTATGCTGTGAGT|AATCTACAAAGACCTGTGCAGTAGTAGAAA
TCTTACGCCCTTCCACTGCAGGGCACAAGT|GGCTCCAAGGTATGCAGCGCAACAAAACCC
AAGTACCAGGCGCATGAAGGACAATCCCCA|CGCATGAAGGACAATCCGATAAGGCAAGTG
GGAGTCATAACTCCCGCCTGATAAGCTGTA|GGAGAACTTGAATCTACAAAGACCTGTGCA
TTTAACTGCACAAGTACCAGGCGCATCACA|ATCCGTATTCCACAATATTAGAAGCACCGA
TGAAGGACAATCCGATAAGGCAAGTGTTCA|CGACGCACCATGCACAAGCTTGTGGATTCG
CCCGCCTGATAAGCTGTATGCTGTGAGTAA|TCTACAAAGACCTGTGCAGTAGTAGAAATC
TAGGAAACGTGCATGCGACGCACCATGCAC|GTACCAGGCGCATGAAGGACAATCCGGCGC
GTAAAGCAGTCCTTACGTACTTCAGCTGGC|TTCCGGATTATACCTGGGTGGCATGGGTGG
TAGAAGCACCGAAGGGCGATATAAGTCACA|GCAGTCCTTACGTACTTCAGCTGGCGGGCC
GCGCATGAAGGACAATCCCCTTGCAGACGA|CAAGTCTCCGGAATTAGGTCGTTGAAAATA
TTCAGTAATCATTGAGTCGTACACCAGTTC|TTCGAGCAACGCCGTGATTTGGAGTCATAA
TGCCCTTATTAAGTCTTACGCCCTTCCACT|AACGCGTAGAGTCGGCTCCAAGGTATGCAG
AGCAGTCCTTACGTACTTCAGCTGGCGGGC|GGATTATACCTGGGTGGCATGGGTGGAGTA
CGCATGAAGGACAATCCCCAAGTGTCTCCC|ACAATCCGATAAGGCAAGTGTTCAGTAATC
CACAAGTACCAGGCGCATGAAGGACAATCC|GCATGAAGGACAATCCTTACAGGCTATGCT
ACGCACAAGTACCAGGCGCATGAAGGACAA|GGAGGTAGGAAACGTGCATGCGACGCACCA
AAGCAGTCCTTACGTACTTCAGCTGGCGGG|CGGATTATACCTGGGTGGCATGGGTGGAGT
TAACTTATGATGCCTGATTATGAGAGGCAA|CTTTTTGCTGCCGGCACCCGTGAATGAAAC
CCCAGGCGCATGAAGGACAATCCCGTGCTT|AATCCCCTTGCAGACGAATATAATCCGAAC
TTAATCCCACCGAGGCAGATGCTAGTGAGC|ATGAAGGACAATCCCCAAGTGTCTCCCCCC
GATATAAGTCACAAGTACCAGGCGCATGAA|CAGCTGGCGGGCCACAAGTACCACAAGTAC
GGCTGTAGCGAGGAGGTAGGAAACGTGCAT|CACAAGTACCACACAAGTACCAGGCGCATG
CCAGGCGCATGAAGGACAATCCGGCGCATG|ACTGCACAAGTACCAGGCGCATCACAAGTA
ATCCTACACAAGTACCAGGCGCATGAAGGA|AGTACCAGGCGCATGAAGGACAATCCGATA
AACTGTACCCTTCGGCTGTAGCGAGGAGGT|AAAGATCACTTAGCACAAGTACCACACAAG
CAGGACAATCCCGAGGGCACAAGTACCAGG|TTGTCGCTACGCAGCTTAAGATAGCGCTCC
CAGGCGCATGAAGGACAATCCAATCCCAGG|ACAAGTACCAGGCGCATGAAGGACAATCCC
AAGTACCACAAGTACCAGGCGCATGAAGGA|TGGTGCCCTTATTAAGTCTTACGCCCTTCC
GACGCACGGCGCCCTAAGTTTTAACTGCAC|ACCAGGCGCATGAAGGACAATCCGTATTCC
TTTTTGCTGCCGGCACCCGTGAATGAAACT|CGCCTGATAAGCTGTATGCTGTGAGTAAAG
CATGCGACGCACCATGCACAAGCTTGTGGA|ATGAAGGACAATCCGGCGCATGAAGGACAA
GGCACAAGTACCAGGCGCATGAAGGACAAT|TTAAGATAGCGCTCCGAGGCACGTACGAAT
AAGTGTTCAGTAATCATTGAGTCGTACACC|GTGGATTCGAGCAACGCCGTGATTTGGAGT
TGTGCCACAAGTACCAGGCGCATGAAGGAC|CAACCGACATGGGACAAGTAAACCACGCAC
AAATGTTCATGTGGCCACAGACACCAACGC|AGAAGGACACTGGGCGACCCGCCAAAACAC
CCCAACAGTTCTTGTGCCACAAGTACCAGG|GATTATGAGAGGCAACCGACATGGGACAAG
AGGACAATCCCGTGCTTTCCGGATTATACC|ACGAATATAATCCGAACTAGCGCGCGCTCC
TATGCGTCGTTCCCAACAGTTCTTGTGCCA|TTATGATGCCTGATTATGAGAGGCAACCGA
GCGCATGAAGGACAATCCTTACAGGCTATG|CACAAGTACCAGGCGCATGAAGGACCACAA
TTGGGGCTACCAAATTAAGTCCCTCACCAC|ACAACAGCCTATGCGTCGTTCCCAACAGTT
CAAATGTTCATGTGGCCACAGACACCAACG|TAGAAGGACACTGGGCGACCCGCCAAAACA
CCAAGTGTCTCCCCCCCTCCGGTGCTGGCC|GTGTTCAGTAATCATTGAGTCGTACACCAG
AGGTAGGAAACGTGCATGCGACGCACCATG|CAAGTACCAGGCGCATGAAGGACAATCCGG
TGCGCGACCCACAAGTACCAGGCGCATGAA|GTACCAGGCGCATGAAGGACAATCCTACAC
CGCACAAGTACCAGGCGCATGAAGGACAAT|GAGGTAGGAAACGTGCATGCGACGCACCAT
TCATTGAGTCGTACACCAGTTCCGACTTTT|ACGCCGTGATTTGGAGTCATAACTCCCGCC
CTTGTAAAGCAGTCCTTACGTACTTCAGCT|GCTTTCCGGATTATACCTGGGTGGCATGGG
AGGCAGATGCTAGTGAGCGGAAGCGACTTA|CCCCAAGTGTCTCCCCCCCTCCGGTGCTGG
AGTCCTTACGTACTTCAGCTGGCGGGCCAC|TTATACCTGGGTGGCATGGGTGGAGTAGTG
ACAATCCGACACAAGTACCAGGCGCATGAA|GTACCAGGCGCATGAAGGACAATCCTTACA
CATGGGACAAGTAAACCACGCACAAGTACC|CCCTTCGGCTGTAGCGAGGAGGTAGGAAAC
GAGGAGGTAGGAAACGTGCATGCGACGCAC|CACACAAGTACCAGGCGCATGAAGGACAAT
CCTACACAAGTACCAGGCGCATGAAGGACA|TACCAGGCGCATGAAGGACAATCCGATAAG
TTGAATCTACAAAGACCTGTGCAGTAGTAG|GGCGCATGAAGGACAATCCAGGACAATCCC
TGGCCAAGCAGTAACTTATGATGCCTGATT|ACCAGTTCCGACTTTTTGCTGCCGGCACCC
TGCATGCGACGCACCATGCACAAGCTTGTG|GCATGAAGGACAATCCGGCGCATGAAGGAC
TTAAGATAGCGCTCCGAGGCACGTACGAAT|GGACAATCCAATCCCAGGCGCATGAAGGAC
ATCCGCCCATCTACGCCGCCGGGAGAACTT|CATGAAGGACAATCCGACACAAGTACCAGG
CACAAGTACCAGGCGCATGAAGGACAATCC|AAGTTTTAACTGCACAAGTACCAGGCGCAT
CGAATGCCTGGCACTTGTAAAGCAGTCCTT|AGGACAATCCCGTGCTTTCCGGATTATACC
TCCTTACGTACTTCAGCTGGCGGGCCACAA|ATACCTGGGTGGCATGGGTGGAGTAGTGTG
ACGCCGCCGGGAGAACTTGAATCTACAAAG|TCCGACACAAGTACCAGGCGCATGAAGGAC
ACAAGTACCAGGCGCATGAAGGACAATCCT|ACATGGGACAAGTAAACCACGCACAAGTAC
TAAGCTGTATGCTGTGAGTAAAGATCACTT|ACCTGTGCAGTAGTAGAAATCTAGTTTTGA
GCGCATGAAGGACCACAAGTACCAGGCGCA|TTACGCCCTTCCACTGCAGGGCACAAGTAC
TGACGCACGGCGCCCTAAGTTTTAACTGCA|TACCAGGCGCATGAAGGACAATCCGTATTC
TACCAGGCGCATGAAGGACAATCCGACACA|GGCGATATAAGTCACAAGTACCAGGCGCAT
ATGCGACGCACCATGCACAAGCTTGTGGAT|TGAAGGACAATCCGGCGCATGAAGGACAAT
TGAAGGACAATCCGCCCATCTACGCCGCCG|TACCAGGCGCATGAAGGACAATCCGACACA
CTTATTAAGTCTTACGCCCTTCCACTGCAG|CGTAGAGTCGGCTCCAAGGTATGCAGCGCA
GCGCATGAAGGACAATCCGGCGCATGAAGG|CACAAGTACCAGGCGCATCACAAGTACCAG
ACAATCCGGCGCATGAAGGACAATCCGCCC|GGCGCATCACAAGTACCAGGCGCATGAAGG
CGAGGGCACAAGTACCAGGCGCATGAAGGA|CAGCTTAAGATAGCGCTCCGAGGCACGTAC
GGCACTTGTAAAGCAGTCCTTACGTACTTC|CCGTGCTTTCCGGATTATACCTGGGTGGCA
AGGACAATCCGTATTCCACAATATTAGAAG|GTACGAATGCCTGGCACTTGTAAAGCAGTC
TACCAGGCGCATGAAGGACAATCCAGGACA|AGGACAATCCTTACAGGCTATGCTTGTCGC
CCAAGCAGTAACTTATGATGCCTGATTATG|AGTTCCGACTTTTTGCTGCCGGCACCCGTG
GCAACGCCGTGATTTGGAGTCATAACTCCC|CCATCTACGCCGCCGGGAGAACTTGAATCT
TGCGACGCACCATGCACAAGCTTGTGGATT|GAAGGACAATCCGGCGCATGAAGGACAATC
ACAATCCCGTGCTTTCCGGATTATACCTGG|AATATAATCCGAACTAGCGCGCGCTCCCAA
TGTGGATTCGAGCAACGCCGTGATTTGGAG|GGACAATCCGCCCATCTACGCCGCCGGGAG
CGAGGCAGATGCTAGTGAGCGGAAGCGACT|ATCCCCAAGTGTCTCCCCCCCTCCGGTGCT
GGCGCATGAAGGACAATCCCCTTGCAGACG|CCAAGTCTCCGGAATTAGGTCGTTGAAAAT
AGTACCAGGCGCATGAAGGACAATCCAATC|AGGGCACAAGTACCAGGCGCATGAAGGACA
CAAGTACCACACAAGTACCAGGCGCATGAA|CGGCGCCCTAAGTTTTAACTGCACAAGTAC
ATGCCTGATTATGAGAGGCAACCGACATGG|GCCGGCACCCGTGAATGAAACTGTACCCTT
AGCTGTATGCTGTGAGTAAAGATCACTTAG|CTGTGCAGTAGTAGAAATCTAGTTTTGACG
TACGCCCTTCCACTGCAGGGCACAAGTACC|TCCAAGGTATGCAGCGCAACAAAACCCGTC
ACCAGTTCCGACTTTTTGCTGCCGGCACCC|AGTCATAACTCCCGCCTGATAAGCTGTATG
TCAGTAATCATTGAGTCGTACACCAGTTCC|TCGAGCAACGCCGTGATTTGGAGTCATAAC
GGCACAAGTACCAGGCGCATGAAGGACAAT|ACAAAACCCGTCACCAAGTCTCCGGAATTA
TGATTATGAGAGGCAACCGACATGGGACAA|CACCCGTGAATGAAACTGTACCCTTCGGCT
AGTTCCGACTTTTTGCTGCCGGCACCCGTG|CATAACTCCCGCCTGATAAGCTGTATGCTG
CGACACAAGTACCAGGCGCATGAAGGACAA|GGCGCATGAAGGACAATCCTTACAGGCTAT
GACGCACCATGCACAAGCTTGTGGATTCGA|GGACAATCCGGCGCATGAAGGACAATCCGC
CGGATTATACCTGGGTGGCATGGGTGGAGT|GCGCGCGCTCCCAAATGTTCATGTGGCCAC
CTTAGCACAAGTACCACACAAGTACCAGGC|TGACGCACGGCGCCCTAAGTTTTAACTGCA
GGCACGTACGAATGCCTGGCACTTGTAAAG|GCGCATGAAGGACAATCCCGTGCTTTCCGG
AGTACCAGGCGCATGAAGGACCACAAGTAC|ATTAAGTCTTACGCCCTTCCACTGCAGGGC
TGTTGGAAAACCATCACGAGCTTGGGGCTA|GTGAGCGGAAGCGACTTACAGACAACAGCC
GCAGTAACTTATGATGCCTGATTATGAGAG|CCGACTTTTTGCTGCCGGCACCCGTGAATG
AAGTACCACACAAGTACCAGGCGCATGAAG|GGCGCCCTAAGTTTTAACTGCACAAGTACC
ATGCACAAGCTTGTGGATTCGAGCAACGCC|CGGCGCATGAAGGACAATCCGCCCATCTAC
ACAATCCCCAAGTGTCTCCCCCCCTCCGGT|AAGGCAAGTGTTCAGTAATCATTGAGTCGT
TCCGAGGCACGTACGAATGCCTGGCACTTG|CCCAGGCGCATGAAGGACAATCCCGTGCTT
GTAGAAATCTAGTTTTGACGCACGGCGCCC|TCCCGAGGGCACAAGTACCAGGCGCATGAA
TCGCTACGCAGCTTAAGATAGCGCTCCGAG|CAGGCGCATGAAGGACAATCCAATCCCAGG
AATCCGATAAGGCAAGTGTTCAGTAATCAT|CATGCACAAGCTTGTGGATTCGAGCAACGC
CCTGGGTGGCATGGGTGGAGTAGTGTGGTG|CCCAAATGTTCATGTGGCCACAGACACCAA
AATATTAGAAGCACCGAAGGGCGATATAAG|GTAAAGCAGTCCTTACGTACTTCAGCTGGC
GCCGTGATTTGGAGTCATAACTCCCGCCTG|TACGCCGCCGGGAGAACTTGAATCTACAAA
TACCAGGCGCATGAAGGACAATCCTTACAG|AAGTACCACAAGTACCAGGCGCATGAAGGA
AAGTACCAGGCGCATGAAGGACAATCCGAT|AGGAAACGTGCATGCGACGCACCATGCACA
GGGTGGAGTAGTGTGGTGCCCTTATTAAGT|TGTGGCCACAGACACCAACGCGTAGAGTCG
ACCACAAGTACCAGGCGCATGAAGGACAAT|CACTGCAGGGCACAAGTACCAGGCGCATGA
CGCCCATCTACGCCGCCGGGAGAACTTGAA|GAAGGACAATCCGACACAAGTACCAGGCGC
AAAACCATCACGAGCTTGGGGCTACCAAAT|GGAAGCGACTTACAGACAACAGCCTATGCG
CCTGGCACTTGTAAAGCAGTCCTTACGTAC|ATCCCGTGCTTTCCGGATTATACCTGGGTG
GTCGTTCCCAACAGTTCTTGTGCCACAAGT|ATGCCTGATTATGAGAGGCAACCGACATGG
ATGAAGGACAATCCGCCCATCTACGCCGCC|GTACCAGGCGCATGAAGGACAATCCGACAC
ATTCGAGCAACGCCGTGATTTGGAGTCATA|ATCCGCCCATCTACGCCGCCGGGAGAACTT
GACAATCCCGTGCTTTCCGGATTATACCTG|GAATATAATCCGAACTAGCGCGCGCTCCCA
CACCAGTTCCGACTTTTTGCTGCCGGCACC|GAGTCATAACTCCCGCCTGATAAGCTGTAT
ACCACACAAGTACCAGGCGCATGAAGGACA|CCCTAAGTTTTAACTGCACAAGTACCAGGC
CCAGGCGCATGAAGGACCACAAGTACCAGG|AGTCTTACGCCCTTCCACTGCAGGGCACAA
CACACAAGTACCAGGCGCATGAAGGACAAT|CTAAGTTTTAACTGCACAAGTACCAGGCGC
AATCCTACACAAGTACCAGGCGCATGAAGG|AAGTACCAGGCGCATGAAGGACAATCCGAT
ACACAAGTACCAGGCGCATGAAGGACAATC|CAGGCGCATGAAGGACAATCCGATAAGGCA
GTCGTACACCAGTTCCGACTTTTTGCTGCC|GATTTGGAGTCATAACTCCCGCCTGATAAG
ATGGGTGGAGTAGTGTGGTGCCCTTATTAA|CATGTGGCCACAGACACCAACGCGTAGAGT
TTACGTACTTCAGCTGGCGGGCCACAAGTA|CCTGGGTGGCATGGGTGGAGTAGTGTGGTG
CAAGTACCAGGCGCATGAAGGACAATCCAA|GCAGGGCACAAGTACCAGGCGCATGAAGGA
GTGTCTCCCCCCCTCCGGTGCTGGCCAAGC|TCAGTAATCATTGAGTCGTACACCAGTTCC
AGTAGAAATCTAGTTTTGACGCACGGCGCC|ATCCCGAGGGCACAAGTACCAGGCGCATGA
AGTGAGCGGAAGCGACTTACAGACAACAGC|TCCCCCCCTCCGGTGCTGGCCAAGCAGTAA
GACTTTTTGCTGCCGGCACCCGTGAATGAA|TCCCGCCTGATAAGCTGTATGCTGTGAGTA
CACAAGTACCAGGCGCATCACAAGTACCAG|TCCACAATATTAGAAGCACCGAAGGGCGAT
CAAGTACCAGGCGCATGAAGGACAATCCAG|ATGAAGGACAATCCTTACAGGCTATGCTTG
GTGTTCAGTAATCATTGAGTCGTACACCAG|GGATTCGAGCAACGCCGTGATTTGGAGTCA
TCCCACCGAGGCAGATGCTAGTGAGCGGAA|AGGACAATCCCCAAGTGTCTCCCCCCCTCC
TATGAGAGGCAACCGACATGGGACAAGTAA|CGTGAATGAAACTGTACCCTTCGGCTGTAG
ACAAGCTTGTGGATTCGAGCAACGCCGTGA|GCATGAAGGACAATCCGCCCATCTACGCCG
GAATCTACAAAGACCTGTGCAGTAGTAGAA|CGCATGAAGGACAATCCAGGACAATCCCGA
TTGTCGCTACGCAGCTTAAGATAGCGCTCC|TACCAGGCGCATGAAGGACAATCCAATCCC
TGAAGGACAATCCAATCCCAGGCGCATGAA|CAGGCGCATGAAGGACAATCCCCTTGCAGA
ACAAGTACCAGGCGCATGAAGGACAATCCA|TGCAGGGCACAAGTACCAGGCGCATGAAGG
TGAAGGACAATCCCGTGCTTTCCGGATTAT|CAGACGAATATAATCCGAACTAGCGCGCGC
CACGGCGCCCTAAGTTTTAACTGCACAAGT|GGCGCATGAAGGACAATCCGTATTCCACAA
AGGACAATCCCGAGGGCACAAGTACCAGGC|TGTCGCTACGCAGCTTAAGATAGCGCTCCG
GCTGCCGGCACCCGTGAATGAAACTGTACC|GATAAGCTGTATGCTGTGAGTAAAGATCAC
CTTACGCCCTTCCACTGCAGGGCACAAGTA|GCTCCAAGGTATGCAGCGCAACAAAACCCG
TACCACACAAGTACCAGGCGCATGAAGGAC|GCCCTAAGTTTTAACTGCACAAGTACCAGG
AGGACAATCCGGCGCATGAAGGACAATCCG|CCAGGCGCATCACAAGTACCAGGCGCATGA
TACGAATGCCTGGCACTTGTAAAGCAGTCC|GAAGGACAATCCCGTGCTTTCCGGATTATA
GGACAATCCGACACAAGTACCAGGCGCATG|AAGTACCAGGCGCATGAAGGACAATCCTTA
AGCTTGGGGCTACCAAATTAAGTCCCTCAC|CAGACAACAGCCTATGCGTCGTTCCCAACA
AAAGCAGTCCTTACGTACTTCAGCTGGCGG|CCGGATTATACCTGGGTGGCATGGGTGGAG
CATGAAGGACAATCCGCCCATCTACGCCGC|AGTACCAGGCGCATGAAGGACAATCCGACA
GCGACTTACAGACAACAGCCTATGCGTCGT|GGTGCTGGCCAAGCAGTAACTTATGATGCC
GTGCCCTTATTAAGTCTTACGCCCTTCCAC|CAACGCGTAGAGTCGGCTCCAAGGTATGCA
AGGACAATCCGACACAAGTACCAGGCGCAT|CAAGTACCAGGCGCATGAAGGACAATCCTT
TCCCAAATGTTCATGTGGCCACAGACACCA|GGATAGAAGGACACTGGGCGACCCGCCAAA
TACCAGGCGCATGAAGGACAATCCCCAAGT|ATGAAGGACAATCCGATAAGGCAAGTGTTC
GGAGTAGTGTGGTGCCCTTATTAAGTCTTA|GCCACAGACACCAACGCGTAGAGTCGGCTC
GAAGGACAATCCGTATTCCACAATATTAGA|ACGTACGAATGCCTGGCACTTGTAAAGCAG
AGTGTTCAGTAATCATTGAGTCGTACACCA|TGGATTCGAGCAACGCCGTGATTTGGAGTC
TCCGACACAAGTACCAGGCGCATGAAGGAC|CAGGCGCATGAAGGACAATCCTTACAGGCT
CTACGCAGCTTAAGATAGCGCTCCGAGGCA|GCGCATGAAGGACAATCCAATCCCAGGCGC
GCAAGTGTTCAGTAATCATTGAGTCGTACA|TTGTGGATTCGAGCAACGCCGTGATTTGGA
GCACGTACGAATGCCTGGCACTTGTAAAGC|CGCATGAAGGACAATCCCGTGCTTTCCGGA
AAGTACCAGGCGCATGAAGGACAATCCGTA|ATAGCGCTCCGAGGCACGTACGAATGCCTG
TTACAGGCTATGCTTGTCGCTACGCAGCTT|GAAGGACCACAAGTACCAGGCGCATGAAGG
GTGCGCGACCCACAAGTACCAGGCGCATGA|AGTACCAGGCGCATGAAGGACAATCCTACA
ATTAAGTCTTACGCCCTTCCACTGCAGGGC|AGAGTCGGCTCCAAGGTATGCAGCGCAACA
TACAGGCTATGCTTGTCGCTACGCAGCTTA|AAGGACCACAAGTACCAGGCGCATGAAGGA
AGCTGGCGGGCCACAAGTACCACAAGTACC|TGGGTGGAGTAGTGTGGTGCCCTTATTAAG
GCTTGGGGCTACCAAATTAAGTCCCTCACC|AGACAACAGCCTATGCGTCGTTCCCAACAG
TACAGACAACAGCCTATGCGTCGTTCCCAA|GGCCAAGCAGTAACTTATGATGCCTGATTA
ACAAAGACCTGTGCAGTAGTAGAAATCTAG|AAGGACAATCCAGGACAATCCCGAGGGCAC
ACCAGGCGCATGAAGGACAATCCGATAAGG|AACGTGCATGCGACGCACCATGCACAAGCT
CGCATGAAGGACAATCCAGGACAATCCCGA|TCCTTACAGGCTATGCTTGTCGCTACGCAG
AACCGACATGGGACAAGTAAACCACGCACA|ACTGTACCCTTCGGCTGTAGCGAGGAGGTA
CAAGTAAACCACGCACAAGTACCAGGCGCA|GCTGTAGCGAGGAGGTAGGAAACGTGCATG
GAAGGACAATCCAGGACAATCCCGAGGGCA|ACAGGCTATGCTTGTCGCTACGCAGCTTAA
AATGAAACTGTACCCTTCGGCTGTAGCGAG|TGAGTAAAGATCACTTAGCACAAGTACCAC
GACCCACAAGTACCAGGCGCATGAAGGACA|AGGCGCATGAAGGACAATCCTACACAAGTA
CCAGGCGCATGAAGGACAATCCGTATTCCA|GCTCCGAGGCACGTACGAATGCCTGGCACT
AGGCGCATGAAGGACAATCCGTATTCCACA|TCCGAGGCACGTACGAATGCCTGGCACTTG
CAGGGCACAAGTACCAGGCGCATGAAGGAC|GCAACAAAACCCGTCACCAAGTCTCCGGAA
TCCCAACAGTTCTTGTGCCACAAGTACCAG|TGATTATGAGAGGCAACCGACATGGGACAA
AGGACAATCCTACACAAGTACCAGGCGCAT|CGCACAAGTACCAGGCGCATGAAGGACAAT
CGCCTGATAAGCTGTATGCTGTGAGTAAAG|TACAAAGACCTGTGCAGTAGTAGAAATCTA
CCGAGGCACGTACGAATGCCTGGCACTTGT|CCAGGCGCATGAAGGACAATCCCGTGCTTT
GTACCAGGCGCATGAAGGACAATCCCCAAG|CATGAAGGACAATCCGATAAGGCAAGTGTT
ATGCCTGGCACTTGTAAAGCAGTCCTTACG|ACAATCCCGTGCTTTCCGGATTATACCTGG
ATGCTGTGAGTAAAGATCACTTAGCACAAG|AGTAGTAGAAATCTAGTTTTGACGCACGGC
AATCCGGCGCATGAAGGACAATCCGCCCAT|CGCATCACAAGTACCAGGCGCATGAAGGAC
GGTAGGAAACGTGCATGCGACGCACCATGC|AAGTACCAGGCGCATGAAGGACAATCCGGC
CCACAAGTACCAGGCGCATGAAGGACCACA|CCCTTATTAAGTCTTACGCCCTTCCACTGC
AACAGTTCTTGTGCCACAAGTACCAGGCGC|TATGAGAGGCAACCGACATGGGACAAGTAA
GCAGACGAATATAATCCGAACTAGCGCGCG|TGAAAATATGCGACCCAGCTTTGTTTGATG
GTTGGAAAACCATCACGAGCTTGGGGCTAC|TGAGCGGAAGCGACTTACAGACAACAGCCT
CGTGCTTTCCGGATTATACCTGGGTGGCAT|TCCGAACTAGCGCGCGCTCCCAAATGTTCA
TGCAGACGAATATAATCCGAACTAGCGCGC|TTGAAAATATGCGACCCAGCTTTGTTTGAT
CTTTCCGGATTATACCTGGGTGGCATGGGT|AACTAGCGCGCGCTCCCAAATGTTCATGTG
GCACAAGTACCACACAAGTACCAGGCGCAT|GCACGGCGCCCTAAGTTTTAACTGCACAAG
AACGCCGTGATTTGGAGTCATAACTCCCGC|ATCTACGCCGCCGGGAGAACTTGAATCTAC
CTGATAAGCTGTATGCTGTGAGTAAAGATC|AAAGACCTGTGCAGTAGTAGAAATCTAGTT
TGCCTGGCACTTGTAAAGCAGTCCTTACGT|CAATCCCGTGCTTTCCGGATTATACCTGGG
CCACAAGTACCAGGCGCATGAAGGACAATC|CGACATGGGACAAGTAAACCACGCACAAGT
GTGCTGGCCAAGCAGTAACTTATGATGCCT|GTACACCAGTTCCGACTTTTTGCTGCCGGC
AGCGAGGAGGTAGGAAACGTGCATGCGACG|TACCACACAAGTACCAGGCGCATGAAGGAC
ACAATCCCGAGGGCACAAGTACCAGGCGCA|CGCTACGCAGCTTAAGATAGCGCTCCGAGG
ACTGCGTCAAGATGTGCGCGACCCACAAGT|TTCTTGTGCCACAAGTACCAGGCGCATGAA
GCGTCAAGATGTGCGCGACCCACAAGTACC|TTGTGCCACAAGTACCAGGCGCATGAAGGA
CAATCCAGGACAATCCCGAGGGCACAAGTA|TATGCTTGTCGCTACGCAGCTTAAGATAGC
CAACAGTTCTTGTGCCACAAGTACCAGGCG|TTATGAGAGGCAACCGACATGGGACAAGTA
GGAAGCGACTTACAGACAACAGCCTATGCG|CTCCGGTGCTGGCCAAGCAGTAACTTATGA
CAGGCGCATGAAGGACCACAAGTACCAGGC|GTCTTACGCCCTTCCACTGCAGGGCACAAG
CACAAGTACCAGGCGCATGAAGGACAATCC|GGCCACAAGTACCACAAGTACCAGGCGCAT
AGTACCAGGCGCATGAAGGACAATCCGATA|GGAAACGTGCATGCGACGCACCATGCACAA
GAGGCAACCGACATGGGACAAGTAAACCAC|ATGAAACTGTACCCTTCGGCTGTAGCGAGG
CATGAAGGACAATCCAGGACAATCCCGAGG|CTTACAGGCTATGCTTGTCGCTACGCAGCT
CCAACAGTTCTTGTGCCACAAGTACCAGGC|ATTATGAGAGGCAACCGACATGGGACAAGT
TAGCACAAGTACCACACAAGTACCAGGCGC|ACGCACGGCGCCCTAAGTTTTAACTGCACA
AGTACCAGGCGCATGAAGGACAATCCTTAC|ACAAGTACCACAAGTACCAGGCGCATGAAG
GGCACCCGTGAATGAAACTGTACCCTTCGG|CTGTATGCTGTGAGTAAAGATCACTTAGCA
TCCGATAAGGCAAGTGTTCAGTAATCATTG|TGCACAAGCTTGTGGATTCGAGCAACGCCG
CATGAAGGACAATCCGGCGCATGAAGGACA|AAGTACCAGGCGCATCACAAGTACCAGGCG
CAGGCGCATCACAAGTACCAGGCGCATGAA|TTAGAAGCACCGAAGGGCGATATAAGTCAC
GTTTTAACTGCACAAGTACCAGGCGCATCA|CAATCCGTATTCCACAATATTAGAAGCACC
TGAGCGGAAGCGACTTACAGACAACAGCCT|CCCCCCTCCGGTGCTGGCCAAGCAGTAACT
ACGTACTTCAGCTGGCGGGCCACAAGTACC|TGGGTGGCATGGGTGGAGTAGTGTGGTGCC
CCTTCCACTGCAGGGCACAAGTACCAGGCG|GGTATGCAGCGCAACAAAACCCGTCACCAA
GGCGATATAAGTCACAAGTACCAGGCGCAT|CTTCAGCTGGCGGGCCACAAGTACCACAAG
CCAGGCGCATGAAGGACAATCCTTACAGGC|GTACCACAAGTACCAGGCGCATGAAGGACC
TTTTAACTGCACAAGTACCAGGCGCATCAC|AATCCGTATTCCACAATATTAGAAGCACCG
CCTTATTAAGTCTTACGCCCTTCCACTGCA|GCGTAGAGTCGGCTCCAAGGTATGCAGCGC
CTCCGAGGCACGTACGAATGCCTGGCACTT|TCCCAGGCGCATGAAGGACAATCCCGTGCT
GATAAGGCAAGTGTTCAGTAATCATTGAGT|ACAAGCTTGTGGATTCGAGCAACGCCGTGA
CGCTCCCAAATGTTCATGTGGCCACAGACA|TGAGGATAGAAGGACACTGGGCGACCCGCC
ACAATCCGCCCATCTACGCCGCCGGGAGAA|GCGCATGAAGGACAATCCGACACAAGTACC
CAAGTGTTCAGTAATCATTGAGTCGTACAC|TGTGGATTCGAGCAACGCCGTGATTTGGAG
TCCGACTTTTTGCTGCCGGCACCCGTGAAT|AACTCCCGCCTGATAAGCTGTATGCTGTGA
TTTGGAGTCATAACTCCCGCCTGATAAGCT|CCGGGAGAACTTGAATCTACAAAGACCTGT
GCTCCGAGGCACGTACGAATGCCTGGCACT|ATCCCAGGCGCATGAAGGACAATCCCGTGC
CGAGCAACGCCGTGATTTGGAGTCATAACT|CGCCCATCTACGCCGCCGGGAGAACTTGAA
AAGACCTGTGCAGTAGTAGAAATCTAGTTT|GACAATCCAGGACAATCCCGAGGGCACAAG
GGACAAGTAAACCACGCACAAGTACCAGGC|TCGGCTGTAGCGAGGAGGTAGGAAACGTGC
ACCCTTCGGCTGTAGCGAGGAGGTAGGAAA|CACTTAGCACAAGTACCACACAAGTACCAG
CGAGGAGGTAGGAAACGTGCATGCGACGCA|CCACACAAGTACCAGGCGCATGAAGGACAA
TCTAGTTTTGACGCACGGCGCCCTAAGTTT|GGCACAAGTACCAGGCGCATGAAGGACAAT
TCGCTTAATCCCACCGAGGCAGATGCTAGT|GCGCATGAAGGACAATCCCCAAGTGTCTCC
CCTTGCAGACGAATATAATCCGAACTAGCG|TCGTTGAAAATATGCGACCCAGCTTTGTTT
TGTAAAGCAGTCCTTACGTACTTCAGCTGG|TTTCCGGATTATACCTGGGTGGCATGGGTG
AAACCACGCACAAGTACCAGGCGCATGAAG|AGCGAGGAGGTAGGAAACGTGCATGCGACG
CATGAAGGACAATCCCGTGCTTTCCGGATT|TGCAGACGAATATAATCCGAACTAGCGCGC
ACAATCCTACACAAGTACCAGGCGCATGAA|ACAAGTACCAGGCGCATGAAGGACAATCCG
ATTAGAAGCACCGAAGGGCGATATAAGTCA|AAGCAGTCCTTACGTACTTCAGCTGGCGGG
CGGGAGAACTTGAATCTACAAAGACCTGTG|CAAGTACCAGGCGCATGAAGGACAATCCAG
ACAAGTAAACCACGCACAAGTACCAGGCGC|GGCTGTAGCGAGGAGGTAGGAAACGTGCAT
AAGTACCAGGCGCATGAAGGACCACAAGTA|TATTAAGTCTTACGCCCTTCCACTGCAGGG
CACCCGTGAATGAAACTGTACCCTTCGGCT|GTATGCTGTGAGTAAAGATCACTTAGCACA
ACAAGTACCAGGCGCATGAAGGACAATCCC|AAACCCGTCACCAAGTCTCCGGAATTAGGT
GTCTCCCCCCCTCCGGTGCTGGCCAAGCAG|AGTAATCATTGAGTCGTACACCAGTTCCGA
CTGCGTCAAGATGTGCGCGACCCACAAGTA|TCTTGTGCCACAAGTACCAGGCGCATGAAG
GCGCATGAAGGACAATCCAATCCCAGGCGC|AGTACCAGGCGCATGAAGGACAATCCCCTT
CGGCGCATGAAGGACAATCCGCCCATCTAC|TCACAAGTACCAGGCGCATGAAGGACAATC
GTTCCCAACAGTTCTTGTGCCACAAGTACC|CCTGATTATGAGAGGCAACCGACATGGGAC
GGGCCACAAGTACCACAAGTACCAGGCGCA|AGTAGTGTGGTGCCCTTATTAAGTCTTACG
GCGATATAAGTCACAAGTACCAGGCGCATG|TTCAGCTGGCGGGCCACAAGTACCACAAGT
AACTGCACAAGTACCAGGCGCATCACAAGT|CGTATTCCACAATATTAGAAGCACCGAAGG
CACAAGTACCAGGCGCATGAAGGACAATCC|GGTAGGAAACGTGCATGCGACGCACCATGC
CAAATTAAGTCCCTCACCACTGCGTCAAGA|ATGCGTCGTTCCCAACAGTTCTTGTGCCAC
GCTATGCTTGTCGCTACGCAGCTTAAGATA|CCACAAGTACCAGGCGCATGAAGGACAATC
CAAGTACCAGGCGCATGAAGGACAATCCGA|TAGGAAACGTGCATGCGACGCACCATGCAC
AATCCGTATTCCACAATATTAGAAGCACCG|AATGCCTGGCACTTGTAAAGCAGTCCTTAC
AGGCAAGTGTTCAGTAATCATTGAGTCGTA|GCTTGTGGATTCGAGCAACGCCGTGATTTG
CCGTATTCCACAATATTAGAAGCACCGAAG|GCCTGGCACTTGTAAAGCAGTCCTTACGTA
ATGCTAGTGAGCGGAAGCGACTTACAGACA|GTGTCTCCCCCCCTCCGGTGCTGGCCAAGC
CTAGCGCGCGCTCCCAAATGTTCATGTGGC|TTGTTTGATGAGGATAGAAGGACACTGGGC
CACTTAGCACAAGTACCACACAAGTACCAG|TTTGACGCACGGCGCCCTAAGTTTTAACTG
TACCAGGCGCATCACAAGTACCAGGCGCAT|ATATTAGAAGCACCGAAGGGCGATATAAGT
TGTTCAGTAATCATTGAGTCGTACACCAGT|GATTCGAGCAACGCCGTGATTTGGAGTCAT
GCAGCTTAAGATAGCGCTCCGAGGCACGTA|ATGAAGGACAATCCAATCCCAGGCGCATGA
ACAAGTACCAGGCGCATCACAAGTACCAGG|CCACAATATTAGAAGCACCGAAGGGCGATA
CGCATGAAGGACAATCCGTATTCCACAATA|GAGGCACGTACGAATGCCTGGCACTTGTAA
GCACAAGTACCAGGCGCATGAAGGACAATC|AGGTAGGAAACGTGCATGCGACGCACCATG
AGCACAAGTACCACACAAGTACCAGGCGCA|CGCACGGCGCCCTAAGTTTTAACTGCACAA
AGCGGAAGCGACTTACAGACAACAGCCTAT|CCCCTCCGGTGCTGGCCAAGCAGTAACTTA
CAATCCTTACAGGCTATGCTTGTCGCTACG|GCGCATGAAGGACCACAAGTACCAGGCGCA
AGTTTTAACTGCACAAGTACCAGGCGCATC|ACAATCCGTATTCCACAATATTAGAAGCAC
CATGAAGGACAATCCTTACAGGCTATGCTT|AAGTACCAGGCGCATGAAGGACCACAAGTA
CAAGTACCAGGCGCATGAAGGACAATCCTA|CATGGGACAAGTAAACCACGCACAAGTACC
GGACAATCCTCGCTTAATCCCACCGAGGCA|AAGTACCAGGCGCATGAAGGACAATCCCCA
CCGAGGGCACAAGTACCAGGCGCATGAAGG|GCAGCTTAAGATAGCGCTCCGAGGCACGTA
GCGCATGAAGGACAATCCTACACAAGTACC|GTAAACCACGCACAAGTACCAGGCGCATGA
ATTTGGAGTCATAACTCCCGCCTGATAAGC|GCCGGGAGAACTTGAATCTACAAAGACCTG
AGGGCACAAGTACCAGGCGCATGAAGGACA|CAACAAAACCCGTCACCAAGTCTCCGGAAT
AAGATAGCGCTCCGAGGCACGTACGAATGC|ACAATCCAATCCCAGGCGCATGAAGGACAA
GATTATGAGAGGCAACCGACATGGGACAAG|ACCCGTGAATGAAACTGTACCCTTCGGCTG
CAATCCCGAGGGCACAAGTACCAGGCGCAT|GCTACGCAGCTTAAGATAGCGCTCCGAGGC
GTACCAGGCGCATGAAGGACAATCCGGCGC|TTAACTGCACAAGTACCAGGCGCATCACAA
GCAGTCCTTACGTACTTCAGCTGGCGGGCC|GATTATACCTGGGTGGCATGGGTGGAGTAG
ACCGAAGGGCGATATAAGTCACAAGTACCA|TTACGTACTTCAGCTGGCGGGCCACAAGTA
AAGTTTTAACTGCACAAGTACCAGGCGCAT|GACAATCCGTATTCCACAATATTAGAAGCA
CCGTGAATGAAACTGTACCCTTCGGCTGTA|TGCTGTGAGTAAAGATCACTTAGCACAAGT
ACCAGGCGCATGAAGGACAATCCCCTTGCA|GTCACCAAGTCTCCGGAATTAGGTCGTTGA
ATCTAGTTTTGACGCACGGCGCCCTAAGTT|GGGCACAAGTACCAGGCGCATGAAGGACAA
GCATGAAGGACAATCCAGGACAATCCCGAG|CCTTACAGGCTATGCTTGTCGCTACGCAGC
GAGGCAGATGCTAGTGAGCGGAAGCGACTT|TCCCCAAGTGTCTCCCCCCCTCCGGTGCTG
GCATGCGACGCACCATGCACAAGCTTGTGG|CATGAAGGACAATCCGGCGCATGAAGGACA
GTTCTTGTGCCACAAGTACCAGGCGCATGA|AGAGGCAACCGACATGGGACAAGTAAACCA
TCACTTAGCACAAGTACCACACAAGTACCA|TTTTGACGCACGGCGCCCTAAGTTTTAACT
TAAACCACGCACAAGTACCAGGCGCATGAA|TAGCGAGGAGGTAGGAAACGTGCATGCGAC
AAGCAGTAACTTATGATGCCTGATTATGAG|TTCCGACTTTTTGCTGCCGGCACCCGTGAA
GCACCATGCACAAGCTTGTGGATTCGAGCA|CAATCCGGCGCATGAAGGACAATCCGCCCA
GAAGGGCGATATAAGTCACAAGTACCAGGC|CGTACTTCAGCTGGCGGGCCACAAGTACCA
TAGTAGAAATCTAGTTTTGACGCACGGCGC|AATCCCGAGGGCACAAGTACCAGGCGCATG
TGCTGGCCAAGCAGTAACTTATGATGCCTG|TACACCAGTTCCGACTTTTTGCTGCCGGCA
TACGCAGCTTAAGATAGCGCTCCGAGGCAC|CGCATGAAGGACAATCCAATCCCAGGCGCA
GGCTACCAAATTAAGTCCCTCACCACTGCG|CAGCCTATGCGTCGTTCCCAACAGTTCTTG
GCGCATGAAGGACAATCCTCGCTTAATCCC|ATCCTACACAAGTACCAGGCGCATGAAGGA
AGTACCAGGCGCATGAAGGACAATCCGTAT|TAGCGCTCCGAGGCACGTACGAATGCCTGG
TTACGCCCTTCCACTGCAGGGCACAAGTAC|CTCCAAGGTATGCAGCGCAACAAAACCCGT
TTGTGGATTCGAGCAACGCCGTGATTTGGA|AGGACAATCCGCCCATCTACGCCGCCGGGA
GGCGCATGAAGGACAATCCGGCGCATGAAG|GCACAAGTACCAGGCGCATCACAAGTACCA
GCGCATGAAGGACAATCCGATAAGGCAAGT|GCATGCGACGCACCATGCACAAGCTTGTGG
ACCAGGCGCATGAAGGACCACAAGTACCAG|AAGTCTTACGCCCTTCCACTGCAGGGCACA
ATCCGAACTAGCGCGCGCTCCCAAATGTTC|CCCAGCTTTGTTTGATGAGGATAGAAGGAC
ATAAGGCAAGTGTTCAGTAATCATTGAGTC|CAAGCTTGTGGATTCGAGCAACGCCGTGAT
GACAATCCAATCCCAGGCGCATGAAGGACA|GCATGAAGGACAATCCCCTTGCAGACGAAT
CGACATGGGACAAGTAAACCACGCACAAGT|GTACCCTTCGGCTGTAGCGAGGAGGTAGGA
AAGGACAATCCGACACAAGTACCAGGCGCA|ACAAGTACCAGGCGCATGAAGGACAATCCT
CTGTAGCGAGGAGGTAGGAAACGTGCATGC|CAAGTACCACACAAGTACCAGGCGCATGAA
CAATCCCCTTGCAGACGAATATAATCCGAA|ATTAGGTCGTTGAAAATATGCGACCCAGCT
CCACGCACAAGTACCAGGCGCATGAAGGAC|GAGGAGGTAGGAAACGTGCATGCGACGCAC
AATCCGAACTAGCGCGCGCTCCCAAATGTT|ACCCAGCTTTGTTTGATGAGGATAGAAGGA
CTGTGAGTAAAGATCACTTAGCACAAGTAC|AGTAGAAATCTAGTTTTGACGCACGGCGCC
CAGGCGCATGAAGGACAATCCGACACAAGT|GATATAAGTCACAAGTACCAGGCGCATGAA
CCCCTCCGGTGCTGGCCAAGCAGTAACTTA|ATTGAGTCGTACACCAGTTCCGACTTTTTG
CGCTTAATCCCACCGAGGCAGATGCTAGTG|CGCATGAAGGACAATCCCCAAGTGTCTCCC
TAGTTTTGACGCACGGCGCCCTAAGTTTTA|CACAAGTACCAGGCGCATGAAGGACAATCC
CAATCCTACACAAGTACCAGGCGCATGAAG|CAAGTACCAGGCGCATGAAGGACAATCCGA
GGCAAGTGTTCAGTAATCATTGAGTCGTAC|CTTGTGGATTCGAGCAACGCCGTGATTTGG
AGCAACGCCGTGATTTGGAGTCATAACTCC|CCCATCTACGCCGCCGGGAGAACTTGAATC
TCTCCCCCCCTCCGGTGCTGGCCAAGCAGT|GTAATCATTGAGTCGTACACCAGTTCCGAC
TACCAGGCGCATGAAGGACAATCCTACACA|GGACAAGTAAACCACGCACAAGTACCAGGC
TAAGTCCCTCACCACTGCGTCAAGATGTGC|TCGTTCCCAACAGTTCTTGTGCCACAAGTA
CAGGCGCATGAAGGACAATCCCCAAGTGTC|AAGGACAATCCGATAAGGCAAGTGTTCAGT
TTCGAGCAACGCCGTGATTTGGAGTCATAA|TCCGCCCATCTACGCCGCCGGGAGAACTTG
GTACCAGGCGCATGAAGGACAATCCGACAC|GGGCGATATAAGTCACAAGTACCAGGCGCA
CCAGGCGCATGAAGGACAATCCAATCCCAG|CACAAGTACCAGGCGCATGAAGGACAATCC
CACAAGTACCAGGCGCATGAAGGACAATCC|AAGATAGCGCTCCGAGGCACGTACGAATGC
GAGCGGAAGCGACTTACAGACAACAGCCTA|CCCCCTCCGGTGCTGGCCAAGCAGTAACTT
ATGAAGGACAATCCCGTGCTTTCCGGATTA|GCAGACGAATATAATCCGAACTAGCGCGCG
CTTACAGGCTATGCTTGTCGCTACGCAGCT|TGAAGGACCACAAGTACCAGGCGCATGAAG
CGCCGCCGGGAGAACTTGAATCTACAAAGA|CCGACACAAGTACCAGGCGCATGAAGGACA
ATCCTTACAGGCTATGCTTGTCGCTACGCA|GCATGAAGGACCACAAGTACCAGGCGCATG
CTCCCCCCCTCCGGTGCTGGCCAAGCAGTA|TAATCATTGAGTCGTACACCAGTTCCGACT
CAGTAACTTATGATGCCTGATTATGAGAGG|CGACTTTTTGCTGCCGGCACCCGTGAATGA
CAATCCGACACAAGTACCAGGCGCATGAAG|TACCAGGCGCATGAAGGACAATCCTTACAG
AAAGACCTGTGCAGTAGTAGAAATCTAGTT|GGACAATCCAGGACAATCCCGAGGGCACAA
TCCGGATTATACCTGGGTGGCATGGGTGGA|TAGCGCGCGCTCCCAAATGTTCATGTGGCC
CCAGTTCCGACTTTTTGCTGCCGGCACCCG|GTCATAACTCCCGCCTGATAAGCTGTATGC
TGTCTCCCCCCCTCCGGTGCTGGCCAAGCA|CAGTAATCATTGAGTCGTACACCAGTTCCG
GTAGTAGAAATCTAGTTTTGACGCACGGCG|CAATCCCGAGGGCACAAGTACCAGGCGCAT
CCAGGCGCATGAAGGACAATCCTCGCTTAA|GACAATCCTACACAAGTACCAGGCGCATGA
ATGAAGGACCACAAGTACCAGGCGCATGAA|GCCCTTCCACTGCAGGGCACAAGTACCAGG
AAGGACAATCCAGGACAATCCCGAGGGCAC|CAGGCTATGCTTGTCGCTACGCAGCTTAAG
ACTTGTAAAGCAGTCCTTACGTACTTCAGC|TGCTTTCCGGATTATACCTGGGTGGCATGG
GACGAATATAATCCGAACTAGCGCGCGCTC|AAATATGCGACCCAGCTTTGTTTGATGAGG
TGTCGCTACGCAGCTTAAGATAGCGCTCCG|ACCAGGCGCATGAAGGACAATCCAATCCCA
AGTACCAGGCGCATGAAGGACAATCCGACA|AGGGCGATATAAGTCACAAGTACCAGGCGC
ACTTTTTGCTGCCGGCACCCGTGAATGAAA|CCCGCCTGATAAGCTGTATGCTGTGAGTAA
ACCACGCACAAGTACCAGGCGCATGAAGGA|CGAGGAGGTAGGAAACGTGCATGCGACGCA
CCCTTATTAAGTCTTACGCCCTTCCACTGC|CGCGTAGAGTCGGCTCCAAGGTATGCAGCG
GCATGAAGGACAATCCAATCCCAGGCGCAT|TACCAGGCGCATGAAGGACAATCCCCTTGC
GGCAGATGCTAGTGAGCGGAAGCGACTTAC|CCCAAGTGTCTCCCCCCCTCCGGTGCTGGC
ATCCTCGCTTAATCCCACCGAGGCAGATGC|CCAGGCGCATGAAGGACAATCCCCAAGTGT
TTCAGCTGGCGGGCCACAAGTACCACAAGT|GCATGGGTGGAGTAGTGTGGTGCCCTTATT
CCCCCTCCGGTGCTGGCCAAGCAGTAACTT|CATTGAGTCGTACACCAGTTCCGACTTTTT
CCCCTTGCAGACGAATATAATCCGAACTAG|GGTCGTTGAAAATATGCGACCCAGCTTTGT
ACCAGGCGCATGAAGGACAATCCAATCCCA|GCACAAGTACCAGGCGCATGAAGGACAATC
AGGACAATCCCCTTGCAGACGAATATAATC|CGGAATTAGGTCGTTGAAAATATGCGACCC
TTTCCGGATTATACCTGGGTGGCATGGGTG|ACTAGCGCGCGCTCCCAAATGTTCATGTGG
GTGAGCGGAAGCGACTTACAGACAACAGCC|CCCCCCCTCCGGTGCTGGCCAAGCAGTAAC
AGATGCTAGTGAGCGGAAGCGACTTACAGA|AAGTGTCTCCCCCCCTCCGGTGCTGGCCAA
GAGTCATAACTCCCGCCTGATAAGCTGTAT|GAGAACTTGAATCTACAAAGACCTGTGCAG
TACCAGGCGCATGAAGGACCACAAGTACCA|TAAGTCTTACGCCCTTCCACTGCAGGGCAC
GTAATCATTGAGTCGTACACCAGTTCCGAC|AGCAACGCCGTGATTTGGAGTCATAACTCC
AGCCTATGCGTCGTTCCCAACAGTTCTTGT|TAACTTATGATGCCTGATTATGAGAGGCAA
CATGGGTGGAGTAGTGTGGTGCCCTTATTA|TCATGTGGCCACAGACACCAACGCGTAGAG
GCCTGATTATGAGAGGCAACCGACATGGGA|CGGCACCCGTGAATGAAACTGTACCCTTCG
CAAGATGTGCGCGACCCACAAGTACCAGGC|GCCACAAGTACCAGGCGCATGAAGGACAAT
GGCGCATGAAGGACAATCCTTACAGGCTAT|CCACAAGTACCAGGCGCATGAAGGACCACA
CCGGCGCATGAAGGACAATCCGCCCATCTA|ATCACAAGTACCAGGCGCATGAAGGACAAT
AAACTGTACCCTTCGGCTGTAGCGAGGAGG|TAAAGATCACTTAGCACAAGTACCACACAA
GTTCATGTGGCCACAGACACCAACGCGTAG|GGACACTGGGCGACCCGCCAAAACACGCGT
CACTGCGTCAAGATGTGCGCGACCCACAAG|GTTCTTGTGCCACAAGTACCAGGCGCATGA
CACAAGTACCAGGCGCATGAAGGACAATCC|GCATGAAGGACAATCCTACACAAGTACCAG
AGGGCGATATAAGTCACAAGTACCAGGCGC|TACTTCAGCTGGCGGGCCACAAGTACCACA
ATGAAGGACAATCCAGGACAATCCCGAGGG|TTACAGGCTATGCTTGTCGCTACGCAGCTT
CACAAGCTTGTGGATTCGAGCAACGCCGTG|CGCATGAAGGACAATCCGCCCATCTACGCC
CCATCTACGCCGCCGGGAGAACTTGAATCT|GGACAATCCGACACAAGTACCAGGCGCATG
CCCCAAGTGTCTCCCCCCCTCCGGTGCTGG|AAGTGTTCAGTAATCATTGAGTCGTACACC
GGCGCATGAAGGACAATCCGACACAAGTAC|TATAAGTCACAAGTACCAGGCGCATGAAGG
TGGAGTCATAACTCCCGCCTGATAAGCTGT|GGGAGAACTTGAATCTACAAAGACCTGTGC
AGTAACTTATGATGCCTGATTATGAGAGGC|GACTTTTTGCTGCCGGCACCCGTGAATGAA
TTATGAGAGGCAACCGACATGGGACAAGTA|CCGTGAATGAAACTGTACCCTTCGGCTGTA
GCACCCGTGAATGAAACTGTACCCTTCGGC|TGTATGCTGTGAGTAAAGATCACTTAGCAC
GAAGCACCGAAGGGCGATATAAGTCACAAG|AGTCCTTACGTACTTCAGCTGGCGGGCCAC
CAGGCGCATGAAGGACAATCCAGGACAATC|ACAATCCTTACAGGCTATGCTTGTCGCTAC
GAAGGACAATCCGATAAGGCAAGTGTTCAG|GACGCACCATGCACAAGCTTGTGGATTCGA
ACTGCAGGGCACAAGTACCAGGCGCATGAA|CAGCGCAACAAAACCCGTCACCAAGTCTCC
CGCATCACAAGTACCAGGCGCATGAAGGAC|AAGCACCGAAGGGCGATATAAGTCACAAGT
TCCGGCGCATGAAGGACAATCCGCCCATCT|CATCACAAGTACCAGGCGCATGAAGGACAA
ACGAATGCCTGGCACTTGTAAAGCAGTCCT|AAGGACAATCCCGTGCTTTCCGGATTATAC
CCGTGATTTGGAGTCATAACTCCCGCCTGA|ACGCCGCCGGGAGAACTTGAATCTACAAAG
CTTCCACTGCAGGGCACAAGTACCAGGCGC|GTATGCAGCGCAACAAAACCCGTCACCAAG
GTACACCAGTTCCGACTTTTTGCTGCCGGC|TTGGAGTCATAACTCCCGCCTGATAAGCTG
AGACAACAGCCTATGCGTCGTTCCCAACAG|CAAGCAGTAACTTATGATGCCTGATTATGA
CCGACTTTTTGCTGCCGGCACCCGTGAATG|ACTCCCGCCTGATAAGCTGTATGCTGTGAG
AGTCCCTCACCACTGCGTCAAGATGTGCGC|GTTCCCAACAGTTCTTGTGCCACAAGTACC
AAGCTTGTGGATTCGAGCAACGCCGTGATT|ATGAAGGACAATCCGCCCATCTACGCCGCC
AATCCCGTGCTTTCCGGATTATACCTGGGT|TATAATCCGAACTAGCGCGCGCTCCCAAAT
CAGTCCTTACGTACTTCAGCTGGCGGGCCA|ATTATACCTGGGTGGCATGGGTGGAGTAGT
TGGGGCTACCAAATTAAGTCCCTCACCACT|CAACAGCCTATGCGTCGTTCCCAACAGTTC
GCGAGGAGGTAGGAAACGTGCATGCGACGC|ACCACACAAGTACCAGGCGCATGAAGGACA
ATGATGCCTGATTATGAGAGGCAACCGACA|GCTGCCGGCACCCGTGAATGAAACTGTACC
ATGAAGGACAATCCTACACAAGTACCAGGC|ACCACGCACAAGTACCAGGCGCATGAAGGA
CATGAAGGACAATCCGTATTCCACAATATT|GGCACGTACGAATGCCTGGCACTTGTAAAG
ACTTACAGACAACAGCCTATGCGTCGTTCC|GCTGGCCAAGCAGTAACTTATGATGCCTGA
GGACAATCCCCAAGTGTCTCCCCCCCTCCG|ATAAGGCAAGTGTTCAGTAATCATTGAGTC
TTGGAGTCATAACTCCCGCCTGATAAGCTG|CGGGAGAACTTGAATCTACAAAGACCTGTG
TAAGTCTTACGCCCTTCCACTGCAGGGCAC|AGTCGGCTCCAAGGTATGCAGCGCAACAAA
AAGGACAATCCGATAAGGCAAGTGTTCAGT|ACGCACCATGCACAAGCTTGTGGATTCGAG
TTCCACTGCAGGGCACAAGTACCAGGCGCA|TATGCAGCGCAACAAAACCCGTCACCAAGT
TCACAAGTACCAGGCGCATGAAGGACAATC|ACCGAAGGGCGATATAAGTCACAAGTACCA
GCTGTATGCTGTGAGTAAAGATCACTTAGC|TGTGCAGTAGTAGAAATCTAGTTTTGACGC
CGCATGAAGGACAATCCCCTTGCAGACGAA|AAGTCTCCGGAATTAGGTCGTTGAAAATAT
AGGCGCATGAAGGACAATCCCCAAGTGTCT|AGGACAATCCGATAAGGCAAGTGTTCAGTA
TCCTTACAGGCTATGCTTGTCGCTACGCAG|CATGAAGGACCACAAGTACCAGGCGCATGA
TGAGAGGCAACCGACATGGGACAAGTAAAC|TGAATGAAACTGTACCCTTCGGCTGTAGCG
TTATACCTGGGTGGCATGGGTGGAGTAGTG|GCGCTCCCAAATGTTCATGTGGCCACAGAC
GCGCGACCCACAAGTACCAGGCGCATGAAG|TACCAGGCGCATGAAGGACAATCCTACACA
TGTTCATGTGGCCACAGACACCAACGCGTA|AGGACACTGGGCGACCCGCCAAAACACGCG
ACGCCGTGATTTGGAGTCATAACTCCCGCC|TCTACGCCGCCGGGAGAACTTGAATCTACA
ATCTACAAAGACCTGTGCAGTAGTAGAAAT|CATGAAGGACAATCCAGGACAATCCCGAGG
ACGAATATAATCCGAACTAGCGCGCGCTCC|AATATGCGACCCAGCTTTGTTTGATGAGGA
CCTATGCGTCGTTCCCAACAGTTCTTGTGC|ACTTATGATGCCTGATTATGAGAGGCAACC
ACAGCCTATGCGTCGTTCCCAACAGTTCTT|AGTAACTTATGATGCCTGATTATGAGAGGC
ATGGGACAAGTAAACCACGCACAAGTACCA|CCTTCGGCTGTAGCGAGGAGGTAGGAAACG
GAAGGACAATCCCCTTGCAGACGAATATAA|TCCGGAATTAGGTCGTTGAAAATATGCGAC
CGGCGCCCTAAGTTTTAACTGCACAAGTAC|CGCATGAAGGACAATCCGTATTCCACAATA
ACGAGCTTGGGGCTACCAAATTAAGTCCCT|TTACAGACAACAGCCTATGCGTCGTTCCCA
GCGCTCCCAAATGTTCATGTGGCCACAGAC|ATGAGGATAGAAGGACACTGGGCGACCCGC
TGATAAGCTGTATGCTGTGAGTAAAGATCA|AAGACCTGTGCAGTAGTAGAAATCTAGTTT
CCATGCACAAGCTTGTGGATTCGAGCAACG|TCCGGCGCATGAAGGACAATCCGCCCATCT
TGCTTGTCGCTACGCAGCTTAAGATAGCGC|AAGTACCAGGCGCATGAAGGACAATCCAAT
GGTGCCCTTATTAAGTCTTACGCCCTTCCA|CCAACGCGTAGAGTCGGCTCCAAGGTATGC
CCCACCGAGGCAGATGCTAGTGAGCGGAAG|GGACAATCCCCAAGTGTCTCCCCCCCTCCG
AAGTACCAGGCGCATGAAGGACAATCCTAC|ATGGGACAAGTAAACCACGCACAAGTACCA
CAGTAGTAGAAATCTAGTTTTGACGCACGG|GACAATCCCGAGGGCACAAGTACCAGGCGC
ACAGACAACAGCCTATGCGTCGTTCCCAAC|GCCAAGCAGTAACTTATGATGCCTGATTAT
TGAAGGACAATCCTTACAGGCTATGCTTGT|GTACCAGGCGCATGAAGGACCACAAGTACC
CCGCCCATCTACGCCGCCGGGAGAACTTGA|TGAAGGACAATCCGACACAAGTACCAGGCG
CAAGTACCAGGCGCATGAAGGACAATCCGA|GAAGGGCGATATAAGTCACAAGTACCAGGC
GGCGCCCTAAGTTTTAACTGCACAAGTACC|GCATGAAGGACAATCCGTATTCCACAATAT
AGTAGTAGAAATCTAGTTTTGACGCACGGC|ACAATCCCGAGGGCACAAGTACCAGGCGCA
CAATCCGCCCATCTACGCCGCCGGGAGAAC|CGCATGAAGGACAATCCGACACAAGTACCA
GTCACAAGTACCAGGCGCATGAAGGACAAT|CGGGCCACAAGTACCACAAGTACCAGGCGC
AGGGCACAAGTACCAGGCGCATGAAGGACA|GCTTAAGATAGCGCTCCGAGGCACGTACGA
CAGACAACAGCCTATGCGTCGTTCCCAACA|CCAAGCAGTAACTTATGATGCCTGATTATG
AGATCACTTAGCACAAGTACCACACAAGTA|TAGTTTTGACGCACGGCGCCCTAAGTTTTA
GCATCACAAGTACCAGGCGCATGAAGGACA|AGCACCGAAGGGCGATATAAGTCACAAGTA
CCAGGCGCATGAAGGACAATCCGACACAAG|CGATATAAGTCACAAGTACCAGGCGCATGA
AATGCCTGGCACTTGTAAAGCAGTCCTTAC|GACAATCCCGTGCTTTCCGGATTATACCTG
AGTACCACACAAGTACCAGGCGCATGAAGG|GCGCCCTAAGTTTTAACTGCACAAGTACCA
AAGATGTGCGCGACCCACAAGTACCAGGCG|CCACAAGTACCAGGCGCATGAAGGACAATC
AGTTTTGACGCACGGCGCCCTAAGTTTTAA|ACAAGTACCAGGCGCATGAAGGACAATCCG
AAGGACAATCCCGTGCTTTCCGGATTATAC|GACGAATATAATCCGAACTAGCGCGCGCTC
TGAAGGACAATCCGACACAAGTACCAGGCG|TCACAAGTACCAGGCGCATGAAGGACAATC
GAAGGACAATCCAATCCCAGGCGCATGAAG|AGGCGCATGAAGGACAATCCCCTTGCAGAC
ACCGAGGCAGATGCTAGTGAGCGGAAGCGA|CAATCCCCAAGTGTCTCCCCCCCTCCGGTG
CAATCCTCGCTTAATCCCACCGAGGCAGAT|TACCAGGCGCATGAAGGACAATCCCCAAGT
ACAAGTACCAGGCGCATGAAGGACAATCCG|CGAAGGGCGATATAAGTCACAAGTACCAGG
ATCCGACACAAGTACCAGGCGCATGAAGGA|CCAGGCGCATGAAGGACAATCCTTACAGGC
GGACAATCCGGCGCATGAAGGACAATCCGC|CAGGCGCATCACAAGTACCAGGCGCATGAA
AATGTTCATGTGGCCACAGACACCAACGCG|GAAGGACACTGGGCGACCCGCCAAAACACG
TTAGAAGCACCGAAGGGCGATATAAGTCAC|AGCAGTCCTTACGTACTTCAGCTGGCGGGC
ACTTCAGCTGGCGGGCCACAAGTACCACAA|TGGCATGGGTGGAGTAGTGTGGTGCCCTTA
GCCTGATAAGCTGTATGCTGTGAGTAAAGA|ACAAAGACCTGTGCAGTAGTAGAAATCTAG
ACCAGGCGCATGAAGGACAATCCTACACAA|GACAAGTAAACCACGCACAAGTACCAGGCG
AAGCGACTTACAGACAACAGCCTATGCGTC|CCGGTGCTGGCCAAGCAGTAACTTATGATG
TGGCATGGGTGGAGTAGTGTGGTGCCCTTA|TGTTCATGTGGCCACAGACACCAACGCGTA
GATAAGCTGTATGCTGTGAGTAAAGATCAC|AGACCTGTGCAGTAGTAGAAATCTAGTTTT
GTAGTGTGGTGCCCTTATTAAGTCTTACGC|ACAGACACCAACGCGTAGAGTCGGCTCCAA
AGGCGCATGAAGGACAATCCTTACAGGCTA|ACCACAAGTACCAGGCGCATGAAGGACCAC
CAAAGACCTGTGCAGTAGTAGAAATCTAGT|AGGACAATCCAGGACAATCCCGAGGGCACA
AGTACCAGGCGCATGAAGGACAATCCCCAA|GCATGAAGGACAATCCGATAAGGCAAGTGT
ACCAGGCGCATGAAGGACAATCCGTATTCC|CGCTCCGAGGCACGTACGAATGCCTGGCAC
CCACAAGTACCACAAGTACCAGGCGCATGA|AGTGTGGTGCCCTTATTAAGTCTTACGCCC
CCCTCACCACTGCGTCAAGATGTGCGCGAC|CCCAACAGTTCTTGTGCCACAAGTACCAGG
GAAGGACAATCCCCAAGTGTCTCCCCCCCT|CCGATAAGGCAAGTGTTCAGTAATCATTGA
TACACCAGTTCCGACTTTTTGCTGCCGGCA|TGGAGTCATAACTCCCGCCTGATAAGCTGT
AGGCGCATGAAGGACAATCCGATAAGGCAA|GTGCATGCGACGCACCATGCACAAGCTTGT
AAATCTAGTTTTGACGCACGGCGCCCTAAG|GAGGGCACAAGTACCAGGCGCATGAAGGAC
ACGCACCATGCACAAGCTTGTGGATTCGAG|GACAATCCGGCGCATGAAGGACAATCCGCC
ATGAAGGACAATCCGACACAAGTACCAGGC|GTCACAAGTACCAGGCGCATGAAGGACAAT
AGTTCTTGTGCCACAAGTACCAGGCGCATG|GAGAGGCAACCGACATGGGACAAGTAAACC
GTACCAGGCGCATCACAAGTACCAGGCGCA|AATATTAGAAGCACCGAAGGGCGATATAAG
GCGCATGAAGGACAATCCAGGACAATCCCG|ATCCTTACAGGCTATGCTTGTCGCTACGCA
TTACAGACAACAGCCTATGCGTCGTTCCCA|TGGCCAAGCAGTAACTTATGATGCCTGATT
GTAGCGAGGAGGTAGGAAACGTGCATGCGA|AGTACCACACAAGTACCAGGCGCATGAAGG
TCCCCCCCTCCGGTGCTGGCCAAGCAGTAA|AATCATTGAGTCGTACACCAGTTCCGACTT
CTGTATGCTGTGAGTAAAGATCACTTAGCA|GTGCAGTAGTAGAAATCTAGTTTTGACGCA
ACAGTTCTTGTGCCACAAGTACCAGGCGCA|ATGAGAGGCAACCGACATGGGACAAGTAAA
TGGAGTAGTGTGGTGCCCTTATTAAGTCTT|GGCCACAGACACCAACGCGTAGAGTCGGCT
TGCCACAAGTACCAGGCGCATGAAGGACAA|ACCGACATGGGACAAGTAAACCACGCACAA
CGGGCCACAAGTACCACAAGTACCAGGCGC|GAGTAGTGTGGTGCCCTTATTAAGTCTTAC
CAACAGCCTATGCGTCGTTCCCAACAGTTC|GCAGTAACTTATGATGCCTGATTATGAGAG
AAGTACCAGGCGCATGAAGGACAATCCAGG|TGAAGGACAATCCTTACAGGCTATGCTTGT
CCAATCCCAGGCGCATGAAGGACAATCCCG|AGGACAATCCCCTTGCAGACGAATATAATC
AATCCCCAAGTGTCTCCCCCCCTCCGGTGC|GGCAAGTGTTCAGTAATCATTGAGTCGTAC
CGCATGAAGGACCACAAGTACCAGGCGCAT|TACGCCCTTCCACTGCAGGGCACAAGTACC
CGTGATTTGGAGTCATAACTCCCGCCTGAT|CGCCGCCGGGAGAACTTGAATCTACAAAGA
CTTCAGCTGGCGGGCCACAAGTACCACAAG|GGCATGGGTGGAGTAGTGTGGTGCCCTTAT
ACAATCCAGGACAATCCCGAGGGCACAAGT|CTATGCTTGTCGCTACGCAGCTTAAGATAG
ACCAGGCGCATCACAAGTACCAGGCGCATG|TATTAGAAGCACCGAAGGGCGATATAAGTC
TCGGCTGTAGCGAGGAGGTAGGAAACGTGC|AGCACAAGTACCACACAAGTACCAGGCGCA
TAGCGCGCGCTCCCAAATGTTCATGTGGCC|TGTTTGATGAGGATAGAAGGACACTGGGCG
CACCATGCACAAGCTTGTGGATTCGAGCAA|AATCCGGCGCATGAAGGACAATCCGCCCAT
GCTTAAGATAGCGCTCCGAGGCACGTACGA|AAGGACAATCCAATCCCAGGCGCATGAAGG
CTCGGATGTTGGAAAACCATCACGAGCTTG|ATGCTAGTGAGCGGAAGCGACTTACAGACA
CAATCCGTATTCCACAATATTAGAAGCACC|GAATGCCTGGCACTTGTAAAGCAGTCCTTA
CAGGCTATGCTTGTCGCTACGCAGCTTAAG|GGACCACAAGTACCAGGCGCATGAAGGACA
AAGGACAATCCTACACAAGTACCAGGCGCA|ACGCACAAGTACCAGGCGCATGAAGGACAA
CGCATGAAGGACAATCCGGCGCATGAAGGA|ACAAGTACCAGGCGCATCACAAGTACCAGG
GGCGCATGAAGGACAATCCCGTGCTTTCCG|CCCTTGCAGACGAATATAATCCGAACTAGC
ACTGCACAAGTACCAGGCGCATCACAAGTA|GTATTCCACAATATTAGAAGCACCGAAGGG
TCCCAGGCGCATGAAGGACAATCCCGTGCT|CAATCCCCTTGCAGACGAATATAATCCGAA
CTTATGATGCCTGATTATGAGAGGCAACCG|TTTGCTGCCGGCACCCGTGAATGAAACTGT
CCCTTGCAGACGAATATAATCCGAACTAGC|GTCGTTGAAAATATGCGACCCAGCTTTGTT
CTTGTGGATTCGAGCAACGCCGTGATTTGG|AAGGACAATCCGCCCATCTACGCCGCCGGG
GATGCTAGTGAGCGGAAGCGACTTACAGAC|AGTGTCTCCCCCCCTCCGGTGCTGGCCAAG
GTACCAGGCGCATGAAGGACAATCCTCGCT|AAGGACAATCCTACACAAGTACCAGGCGCA
CGAACTAGCGCGCGCTCCCAAATGTTCATG|AGCTTTGTTTGATGAGGATAGAAGGACACT
CGCCGTGATTTGGAGTCATAACTCCCGCCT|CTACGCCGCCGGGAGAACTTGAATCTACAA
GGCCACAAGTACCACAAGTACCAGGCGCAT|GTAGTGTGGTGCCCTTATTAAGTCTTACGC
GGCGCATGAAGGACAATCCGTATTCCACAA|CCGAGGCACGTACGAATGCCTGGCACTTGT
CTTACGTACTTCAGCTGGCGGGCCACAAGT|ACCTGGGTGGCATGGGTGGAGTAGTGTGGT
GCTGTAGCGAGGAGGTAGGAAACGTGCATG|ACAAGTACCACACAAGTACCAGGCGCATGA
GCGGAAGCGACTTACAGACAACAGCCTATG|CCCTCCGGTGCTGGCCAAGCAGTAACTTAT
GAGAGGCAACCGACATGGGACAAGTAAACC|GAATGAAACTGTACCCTTCGGCTGTAGCGA
TCCCTCACCACTGCGTCAAGATGTGCGCGA|TCCCAACAGTTCTTGTGCCACAAGTACCAG
CGGTGCTGGCCAAGCAGTAACTTATGATGC|TCGTACACCAGTTCCGACTTTTTGCTGCCG
GCATGAAGGACAATCCGGCGCATGAAGGAC|CAAGTACCAGGCGCATCACAAGTACCAGGC
AAGTACCAGGCGCATGAAGGACAATCCTCG|TGAAGGACAATCCTACACAAGTACCAGGCG
CGCGACCCACAAGTACCAGGCGCATGAAGG|ACCAGGCGCATGAAGGACAATCCTACACAA
CACCGAGGCAGATGCTAGTGAGCGGAAGCG|ACAATCCCCAAGTGTCTCCCCCCCTCCGGT
CACGAGCTTGGGGCTACCAAATTAAGTCCC|CTTACAGACAACAGCCTATGCGTCGTTCCC
AAGGACCACAAGTACCAGGCGCATGAAGGA|CTTCCACTGCAGGGCACAAGTACCAGGCGC
CACAAGTACCAGGCGCATGAAGGACAATCC|CCGAAGGGCGATATAAGTCACAAGTACCAG
GTACCAGGCGCATGAAGGACCACAAGTACC|TTAAGTCTTACGCCCTTCCACTGCAGGGCA
TAGCGCTCCGAGGCACGTACGAATGCCTGG|TCCAATCCCAGGCGCATGAAGGACAATCCC
AGTACCAGGCGCATGAAGGACAATCCGGCG|TTTAACTGCACAAGTACCAGGCGCATCACA
CATGAAGGACAATCCGATAAGGCAAGTGTT|TGCGACGCACCATGCACAAGCTTGTGGATT
ACACAAGTACCAGGCGCATGAAGGACAATC|TAAGTTTTAACTGCACAAGTACCAGGCGCA
GACCTGTGCAGTAGTAGAAATCTAGTTTTG|CAATCCAGGACAATCCCGAGGGCACAAGTA
GCATGAAGGACAATCCGACACAAGTACCAG|AAGTCACAAGTACCAGGCGCATGAAGGACA
ACAAGTACCAGGCGCATGAAGGACAATCCG|GTAGGAAACGTGCATGCGACGCACCATGCA
ATAAGCTGTATGCTGTGAGTAAAGATCACT|GACCTGTGCAGTAGTAGAAATCTAGTTTTG
GTACCAGGCGCATGAAGGACAATCCTACAC|GGGACAAGTAAACCACGCACAAGTACCAGG
GCGCATGAAGGACAATCCGCCCATCTACGC|ACAAGTACCAGGCGCATGAAGGACAATCCG
